fecha,estacion_id,estacion,lat,lon,linea,entradas,salidas,total,hora
2025-06-29 21:00:00,120,Tláhuac,19.2978,-99.0123,L12,217,184,401,21
2025-06-10 06:00:00,10,Centro,19.4326,-99.1332,L1,99,99,198,6
2025-06-29 19:00:00,120,Tláhuac,19.2978,-99.0123,L12,802,947,1749,19
2025-06-16 11:00:00,120,Tláhuac,19.2978,-99.0123,L12,202,232,434,11
2025-06-11 22:00:00,10,Centro,19.4326,-99.1332,L1,108,107,215,22
2025-06-25 17:00:00,200,Estadio_Azteca,19.302,-99.15,NA,766,699,1465,17
2025-06-24 05:00:00,200,Estadio_Azteca,19.302,-99.15,NA,182,182,364,5
2025-06-24 20:00:00,200,Estadio_Azteca,19.302,-99.15,NA,179,191,370,20
2025-06-13 20:00:00,10,Centro,19.4326,-99.1332,L1,80,93,173,20
2025-06-30 23:00:00,120,Tláhuac,19.2978,-99.0123,L12,202,244,446,23
2025-06-10 08:00:00,10,Centro,19.4326,-99.1332,L1,382,336,718,8
2025-06-28 22:00:00,200,Estadio_Azteca,19.302,-99.15,NA,172,199,371,22
2025-06-02 08:00:00,120,Tláhuac,19.2978,-99.0123,L12,754,741,1495,8
2025-06-17 04:00:00,120,Tláhuac,19.2978,-99.0123,L12,209,212,421,4
2025-06-08 21:00:00,120,Tláhuac,19.2978,-99.0123,L12,213,241,454,21
2025-06-02 21:00:00,120,Tláhuac,19.2978,-99.0123,L12,221,183,404,21
2025-06-01 09:00:00,10,Centro,19.4326,-99.1332,L1,90,107,197,9
2025-06-23 19:00:00,120,Tláhuac,19.2978,-99.0123,L12,864,880,1744,19
2025-06-26 15:00:00,120,Tláhuac,19.2978,-99.0123,L12,215,228,443,15
2025-06-27 22:00:00,10,Centro,19.4326,-99.1332,L1,92,85,177,22
2025-06-09 15:00:00,120,Tláhuac,19.2978,-99.0123,L12,204,240,444,15
2025-06-17 17:00:00,200,Estadio_Azteca,19.302,-99.15,NA,655,793,1448,17
2025-06-21 05:00:00,120,Tláhuac,19.2978,-99.0123,L12,222,240,462,5
2025-06-15 16:00:00,200,Estadio_Azteca,19.302,-99.15,NA,172,166,338,16
2025-06-05 20:00:00,10,Centro,19.4326,-99.1332,L1,108,101,209,20
2025-06-23 00:00:00,10,Centro,19.4326,-99.1332,L1,112,94,206,0
2025-06-14 21:00:00,200,Estadio_Azteca,19.302,-99.15,NA,174,193,367,21
2025-06-04 11:00:00,10,Centro,19.4326,-99.1332,L1,95,102,197,11
2025-06-20 17:00:00,200,Estadio_Azteca,19.302,-99.15,NA,702,700,1402,17
2025-06-14 09:00:00,10,Centro,19.4326,-99.1332,L1,86,105,191,9
2025-06-17 12:00:00,200,Estadio_Azteca,19.302,-99.15,NA,167,186,353,12
2025-06-28 19:00:00,200,Estadio_Azteca,19.302,-99.15,NA,715,710,1425,19
2025-06-02 13:00:00,120,Tláhuac,19.2978,-99.0123,L12,216,257,473,13
2025-06-03 13:00:00,200,Estadio_Azteca,19.302,-99.15,NA,181,185,366,13
2025-06-24 23:00:00,200,Estadio_Azteca,19.302,-99.15,NA,186,158,344,23
2025-06-25 06:00:00,200,Estadio_Azteca,19.302,-99.15,NA,196,174,370,6
2025-06-24 03:00:00,10,Centro,19.4326,-99.1332,L1,99,92,191,3
2025-06-29 02:00:00,120,Tláhuac,19.2978,-99.0123,L12,232,199,431,2
2025-06-06 20:00:00,10,Centro,19.4326,-99.1332,L1,115,97,212,20
2025-06-08 01:00:00,200,Estadio_Azteca,19.302,-99.15,NA,163,171,334,1
2025-06-19 11:00:00,10,Centro,19.4326,-99.1332,L1,92,106,198,11
2025-06-21 09:00:00,10,Centro,19.4326,-99.1332,L1,89,97,186,9
2025-06-27 21:00:00,120,Tláhuac,19.2978,-99.0123,L12,232,198,430,21
2025-06-09 18:00:00,120,Tláhuac,19.2978,-99.0123,L12,925,796,1721,18
2025-06-20 08:00:00,200,Estadio_Azteca,19.302,-99.15,NA,619,669,1288,8
2025-06-27 20:00:00,200,Estadio_Azteca,19.302,-99.15,NA,169,195,364,20
2025-06-18 23:00:00,120,Tláhuac,19.2978,-99.0123,L12,199,199,398,23
2025-06-14 12:00:00,200,Estadio_Azteca,19.302,-99.15,NA,173,172,345,12
2025-06-05 03:00:00,120,Tláhuac,19.2978,-99.0123,L12,235,211,446,3
2025-06-25 11:00:00,120,Tláhuac,19.2978,-99.0123,L12,191,226,417,11
2025-06-13 21:00:00,10,Centro,19.4326,-99.1332,L1,92,102,194,21
2025-06-07 21:00:00,120,Tláhuac,19.2978,-99.0123,L12,255,237,492,21
2025-06-25 05:00:00,200,Estadio_Azteca,19.302,-99.15,NA,166,201,367,5
2025-06-05 06:00:00,200,Estadio_Azteca,19.302,-99.15,NA,197,162,359,6
2025-06-02 20:00:00,10,Centro,19.4326,-99.1332,L1,90,84,174,20
2025-06-23 10:00:00,10,Centro,19.4326,-99.1332,L1,107,92,199,10
2025-06-21 23:00:00,120,Tláhuac,19.2978,-99.0123,L12,253,230,483,23
2025-06-06 00:00:00,200,Estadio_Azteca,19.302,-99.15,NA,168,156,324,0
2025-06-02 12:00:00,200,Estadio_Azteca,19.302,-99.15,NA,185,183,368,12
2025-06-25 12:00:00,200,Estadio_Azteca,19.302,-99.15,NA,158,189,347,12
2025-06-13 19:00:00,10,Centro,19.4326,-99.1332,L1,398,413,811,19
2025-06-03 14:00:00,10,Centro,19.4326,-99.1332,L1,95,106,201,14
2025-06-23 00:00:00,120,Tláhuac,19.2978,-99.0123,L12,220,200,420,0
2025-06-04 08:00:00,120,Tláhuac,19.2978,-99.0123,L12,793,771,1564,8
2025-06-02 09:00:00,200,Estadio_Azteca,19.302,-99.15,NA,168,147,315,9
2025-06-09 06:00:00,10,Centro,19.4326,-99.1332,L1,95,111,206,6
2025-06-07 18:00:00,120,Tláhuac,19.2978,-99.0123,L12,793,938,1731,18
2025-06-21 22:00:00,120,Tláhuac,19.2978,-99.0123,L12,249,225,474,22
2025-06-26 22:00:00,10,Centro,19.4326,-99.1332,L1,97,89,186,22
2025-06-12 09:00:00,120,Tláhuac,19.2978,-99.0123,L12,213,222,435,9
2025-06-08 07:00:00,10,Centro,19.4326,-99.1332,L1,349,360,709,7
2025-06-24 15:00:00,10,Centro,19.4326,-99.1332,L1,98,94,192,15
2025-06-08 13:00:00,200,Estadio_Azteca,19.302,-99.15,NA,168,169,337,13
2025-06-11 20:00:00,120,Tláhuac,19.2978,-99.0123,L12,192,201,393,20
2025-06-19 13:00:00,10,Centro,19.4326,-99.1332,L1,91,111,202,13
2025-06-04 05:00:00,10,Centro,19.4326,-99.1332,L1,95,88,183,5
2025-06-28 09:00:00,120,Tláhuac,19.2978,-99.0123,L12,209,249,458,9
2025-06-04 12:00:00,10,Centro,19.4326,-99.1332,L1,83,100,183,12
2025-06-05 22:00:00,120,Tláhuac,19.2978,-99.0123,L12,221,195,416,22
2025-06-29 17:00:00,120,Tláhuac,19.2978,-99.0123,L12,790,947,1737,17
2025-06-05 00:00:00,10,Centro,19.4326,-99.1332,L1,84,100,184,0
2025-06-30 01:00:00,10,Centro,19.4326,-99.1332,L1,105,90,195,1
2025-06-10 15:00:00,120,Tláhuac,19.2978,-99.0123,L12,223,223,446,15
2025-06-01 23:00:00,200,Estadio_Azteca,19.302,-99.15,NA,191,187,378,23
2025-06-17 14:00:00,120,Tláhuac,19.2978,-99.0123,L12,245,206,451,14
2025-06-11 02:00:00,200,Estadio_Azteca,19.302,-99.15,NA,180,176,356,2
2025-06-07 15:00:00,200,Estadio_Azteca,19.302,-99.15,NA,186,181,367,15
2025-06-19 18:00:00,200,Estadio_Azteca,19.302,-99.15,NA,783,662,1445,18
2025-06-26 18:00:00,200,Estadio_Azteca,19.302,-99.15,NA,719,707,1426,18
2025-06-19 07:00:00,200,Estadio_Azteca,19.302,-99.15,NA,574,627,1201,7
2025-06-05 00:00:00,200,Estadio_Azteca,19.302,-99.15,NA,160,194,354,0
2025-06-09 14:00:00,10,Centro,19.4326,-99.1332,L1,100,88,188,14
2025-06-24 20:00:00,120,Tláhuac,19.2978,-99.0123,L12,234,214,448,20
2025-06-04 19:00:00,10,Centro,19.4326,-99.1332,L1,382,398,780,19
2025-06-26 13:00:00,10,Centro,19.4326,-99.1332,L1,102,111,213,13
2025-06-25 00:00:00,10,Centro,19.4326,-99.1332,L1,109,99,208,0
2025-06-03 17:00:00,200,Estadio_Azteca,19.302,-99.15,NA,667,784,1451,17
2025-06-06 02:00:00,200,Estadio_Azteca,19.302,-99.15,NA,196,161,357,2
2025-06-10 00:00:00,10,Centro,19.4326,-99.1332,L1,98,88,186,0
2025-06-29 16:00:00,120,Tláhuac,19.2978,-99.0123,L12,186,210,396,16
2025-06-27 05:00:00,200,Estadio_Azteca,19.302,-99.15,NA,187,166,353,5
2025-06-27 06:00:00,10,Centro,19.4326,-99.1332,L1,98,104,202,6
2025-06-19 22:00:00,120,Tláhuac,19.2978,-99.0123,L12,217,204,421,22
2025-06-05 03:00:00,200,Estadio_Azteca,19.302,-99.15,NA,173,159,332,3
2025-06-05 11:00:00,120,Tláhuac,19.2978,-99.0123,L12,245,203,448,11
2025-06-15 07:00:00,120,Tláhuac,19.2978,-99.0123,L12,720,793,1513,7
2025-06-26 17:00:00,120,Tláhuac,19.2978,-99.0123,L12,972,838,1810,17
2025-06-08 10:00:00,120,Tláhuac,19.2978,-99.0123,L12,227,267,494,10
2025-06-24 04:00:00,10,Centro,19.4326,-99.1332,L1,100,103,203,4
2025-06-15 11:00:00,10,Centro,19.4326,-99.1332,L1,88,94,182,11
2025-06-23 02:00:00,120,Tláhuac,19.2978,-99.0123,L12,214,220,434,2
2025-06-16 11:00:00,200,Estadio_Azteca,19.302,-99.15,NA,179,172,351,11
2025-06-25 09:00:00,200,Estadio_Azteca,19.302,-99.15,NA,195,185,380,9
2025-06-28 06:00:00,120,Tláhuac,19.2978,-99.0123,L12,247,233,480,6
2025-06-21 09:00:00,200,Estadio_Azteca,19.302,-99.15,NA,210,180,390,9
2025-06-16 12:00:00,120,Tláhuac,19.2978,-99.0123,L12,198,195,393,12
2025-06-06 09:00:00,120,Tláhuac,19.2978,-99.0123,L12,224,185,409,9
2025-06-27 06:00:00,120,Tláhuac,19.2978,-99.0123,L12,189,220,409,6
2025-06-06 07:00:00,10,Centro,19.4326,-99.1332,L1,359,366,725,7
2025-06-23 13:00:00,120,Tláhuac,19.2978,-99.0123,L12,208,208,416,13
2025-06-21 12:00:00,120,Tláhuac,19.2978,-99.0123,L12,201,230,431,12
2025-06-17 09:00:00,120,Tláhuac,19.2978,-99.0123,L12,222,196,418,9
2025-06-01 22:00:00,200,Estadio_Azteca,19.302,-99.15,NA,177,187,364,22
2025-06-07 20:00:00,10,Centro,19.4326,-99.1332,L1,100,99,199,20
2025-06-20 20:00:00,10,Centro,19.4326,-99.1332,L1,99,99,198,20
2025-06-18 13:00:00,200,Estadio_Azteca,19.302,-99.15,NA,185,178,363,13
2025-06-21 11:00:00,10,Centro,19.4326,-99.1332,L1,93,103,196,11
2025-06-16 04:00:00,10,Centro,19.4326,-99.1332,L1,91,107,198,4
2025-06-08 05:00:00,120,Tláhuac,19.2978,-99.0123,L12,192,217,409,5
2025-06-03 22:00:00,200,Estadio_Azteca,19.302,-99.15,NA,188,182,370,22
2025-06-03 08:00:00,120,Tláhuac,19.2978,-99.0123,L12,802,799,1601,8
2025-06-30 21:00:00,200,Estadio_Azteca,19.302,-99.15,NA,184,180,364,21
2025-06-15 21:00:00,120,Tláhuac,19.2978,-99.0123,L12,250,211,461,21
2025-06-05 06:00:00,120,Tláhuac,19.2978,-99.0123,L12,214,238,452,6
2025-06-12 05:00:00,10,Centro,19.4326,-99.1332,L1,111,106,217,5
2025-06-21 06:00:00,200,Estadio_Azteca,19.302,-99.15,NA,188,202,390,6
2025-06-19 00:00:00,10,Centro,19.4326,-99.1332,L1,109,97,206,0
2025-06-09 20:00:00,120,Tláhuac,19.2978,-99.0123,L12,201,219,420,20
2025-06-23 06:00:00,10,Centro,19.4326,-99.1332,L1,110,92,202,6
2025-06-27 03:00:00,10,Centro,19.4326,-99.1332,L1,112,94,206,3
2025-06-02 18:00:00,10,Centro,19.4326,-99.1332,L1,430,384,814,18
2025-06-13 03:00:00,200,Estadio_Azteca,19.302,-99.15,NA,183,177,360,3
2025-06-20 20:00:00,120,Tláhuac,19.2978,-99.0123,L12,208,206,414,20
2025-06-18 03:00:00,120,Tláhuac,19.2978,-99.0123,L12,200,221,421,3
2025-06-08 20:00:00,120,Tláhuac,19.2978,-99.0123,L12,244,220,464,20
2025-06-17 23:00:00,10,Centro,19.4326,-99.1332,L1,100,89,189,23
2025-06-01 17:00:00,120,Tláhuac,19.2978,-99.0123,L12,805,919,1724,17
2025-06-29 22:00:00,120,Tláhuac,19.2978,-99.0123,L12,216,258,474,22
2025-06-15 19:00:00,10,Centro,19.4326,-99.1332,L1,416,358,774,19
2025-06-13 08:00:00,120,Tláhuac,19.2978,-99.0123,L12,769,811,1580,8
2025-06-17 08:00:00,200,Estadio_Azteca,19.302,-99.15,NA,644,601,1245,8
2025-06-28 22:00:00,120,Tláhuac,19.2978,-99.0123,L12,233,228,461,22
2025-06-29 11:00:00,120,Tláhuac,19.2978,-99.0123,L12,219,215,434,11
2025-06-22 17:00:00,120,Tláhuac,19.2978,-99.0123,L12,914,921,1835,17
2025-06-19 15:00:00,200,Estadio_Azteca,19.302,-99.15,NA,158,176,334,15
2025-06-29 23:00:00,120,Tláhuac,19.2978,-99.0123,L12,228,190,418,23
2025-06-28 14:00:00,120,Tláhuac,19.2978,-99.0123,L12,234,211,445,14
2025-06-29 23:00:00,10,Centro,19.4326,-99.1332,L1,95,98,193,23
2025-06-18 20:00:00,120,Tláhuac,19.2978,-99.0123,L12,216,229,445,20
2025-06-10 23:00:00,10,Centro,19.4326,-99.1332,L1,89,93,182,23
2025-06-25 19:00:00,120,Tláhuac,19.2978,-99.0123,L12,901,858,1759,19
2025-06-20 17:00:00,10,Centro,19.4326,-99.1332,L1,430,378,808,17
2025-06-11 07:00:00,200,Estadio_Azteca,19.302,-99.15,NA,638,626,1264,7
2025-06-14 04:00:00,120,Tláhuac,19.2978,-99.0123,L12,231,223,454,4
2025-06-04 21:00:00,10,Centro,19.4326,-99.1332,L1,100,89,189,21
2025-06-04 10:00:00,200,Estadio_Azteca,19.302,-99.15,NA,191,163,354,10
2025-06-11 10:00:00,10,Centro,19.4326,-99.1332,L1,112,111,223,10
2025-06-07 10:00:00,10,Centro,19.4326,-99.1332,L1,96,98,194,10
2025-06-25 03:00:00,10,Centro,19.4326,-99.1332,L1,91,106,197,3
2025-06-20 21:00:00,120,Tláhuac,19.2978,-99.0123,L12,241,199,440,21
2025-06-14 21:00:00,10,Centro,19.4326,-99.1332,L1,106,95,201,21
2025-06-09 20:00:00,200,Estadio_Azteca,19.302,-99.15,NA,194,184,378,20
2025-06-05 18:00:00,120,Tláhuac,19.2978,-99.0123,L12,823,868,1691,18
2025-06-08 17:00:00,200,Estadio_Azteca,19.302,-99.15,NA,684,794,1478,17
2025-06-15 15:00:00,200,Estadio_Azteca,19.302,-99.15,NA,201,169,370,15
2025-06-22 00:00:00,120,Tláhuac,19.2978,-99.0123,L12,212,225,437,0
2025-06-07 09:00:00,10,Centro,19.4326,-99.1332,L1,110,102,212,9
2025-06-04 05:00:00,120,Tláhuac,19.2978,-99.0123,L12,247,215,462,5
2025-06-28 04:00:00,120,Tláhuac,19.2978,-99.0123,L12,213,186,399,4
2025-06-18 03:00:00,200,Estadio_Azteca,19.302,-99.15,NA,177,207,384,3
2025-06-23 11:00:00,200,Estadio_Azteca,19.302,-99.15,NA,197,197,394,11
2025-06-07 15:00:00,10,Centro,19.4326,-99.1332,L1,98,86,184,15
2025-06-14 14:00:00,120,Tláhuac,19.2978,-99.0123,L12,206,203,409,14
2025-06-08 16:00:00,120,Tláhuac,19.2978,-99.0123,L12,210,238,448,16
2025-06-09 13:00:00,10,Centro,19.4326,-99.1332,L1,104,102,206,13
2025-06-22 08:00:00,200,Estadio_Azteca,19.302,-99.15,NA,682,566,1248,8
2025-06-16 10:00:00,10,Centro,19.4326,-99.1332,L1,101,98,199,10
2025-06-02 16:00:00,120,Tláhuac,19.2978,-99.0123,L12,230,200,430,16
2025-06-16 18:00:00,120,Tláhuac,19.2978,-99.0123,L12,781,895,1676,18
2025-06-07 08:00:00,10,Centro,19.4326,-99.1332,L1,317,384,701,8
2025-06-20 15:00:00,200,Estadio_Azteca,19.302,-99.15,NA,183,167,350,15
2025-06-01 18:00:00,10,Centro,19.4326,-99.1332,L1,368,434,802,18
2025-06-30 21:00:00,120,Tláhuac,19.2978,-99.0123,L12,188,214,402,21
2025-06-10 07:00:00,200,Estadio_Azteca,19.302,-99.15,NA,656,596,1252,7
2025-06-11 20:00:00,10,Centro,19.4326,-99.1332,L1,94,102,196,20
2025-06-24 17:00:00,200,Estadio_Azteca,19.302,-99.15,NA,664,781,1445,17
2025-06-12 21:00:00,200,Estadio_Azteca,19.302,-99.15,NA,162,198,360,21
2025-06-25 04:00:00,200,Estadio_Azteca,19.302,-99.15,NA,179,152,331,4
2025-06-24 17:00:00,10,Centro,19.4326,-99.1332,L1,444,402,846,17
2025-06-24 00:00:00,10,Centro,19.4326,-99.1332,L1,97,90,187,0
2025-06-29 05:00:00,10,Centro,19.4326,-99.1332,L1,101,109,210,5
2025-06-22 22:00:00,120,Tláhuac,19.2978,-99.0123,L12,196,239,435,22
2025-06-06 18:00:00,10,Centro,19.4326,-99.1332,L1,421,350,771,18
2025-06-26 11:00:00,200,Estadio_Azteca,19.302,-99.15,NA,170,201,371,11
2025-06-27 10:00:00,10,Centro,19.4326,-99.1332,L1,88,106,194,10
2025-06-04 04:00:00,10,Centro,19.4326,-99.1332,L1,102,109,211,4
2025-06-26 20:00:00,200,Estadio_Azteca,19.302,-99.15,NA,150,177,327,20
2025-06-29 05:00:00,200,Estadio_Azteca,19.302,-99.15,NA,187,183,370,5
2025-06-26 00:00:00,200,Estadio_Azteca,19.302,-99.15,NA,187,201,388,0
2025-06-20 22:00:00,10,Centro,19.4326,-99.1332,L1,94,95,189,22
2025-06-08 08:00:00,10,Centro,19.4326,-99.1332,L1,383,345,728,8
2025-06-27 15:00:00,200,Estadio_Azteca,19.302,-99.15,NA,181,166,347,15
2025-06-14 20:00:00,10,Centro,19.4326,-99.1332,L1,91,96,187,20
2025-06-01 14:00:00,10,Centro,19.4326,-99.1332,L1,103,120,223,14
2025-06-07 13:00:00,120,Tláhuac,19.2978,-99.0123,L12,221,218,439,13
2025-06-18 22:00:00,10,Centro,19.4326,-99.1332,L1,99,104,203,22
2025-06-18 13:00:00,120,Tláhuac,19.2978,-99.0123,L12,203,241,444,13
2025-06-22 23:00:00,200,Estadio_Azteca,19.302,-99.15,NA,201,169,370,23
2025-06-07 16:00:00,10,Centro,19.4326,-99.1332,L1,95,93,188,16
2025-06-16 12:00:00,200,Estadio_Azteca,19.302,-99.15,NA,166,191,357,12
2025-06-12 08:00:00,120,Tláhuac,19.2978,-99.0123,L12,707,777,1484,8
2025-06-22 11:00:00,200,Estadio_Azteca,19.302,-99.15,NA,188,172,360,11
2025-06-22 18:00:00,200,Estadio_Azteca,19.302,-99.15,NA,653,773,1426,18
2025-06-24 05:00:00,10,Centro,19.4326,-99.1332,L1,83,85,168,5
2025-06-05 12:00:00,120,Tláhuac,19.2978,-99.0123,L12,206,225,431,12
2025-06-25 12:00:00,10,Centro,19.4326,-99.1332,L1,98,83,181,12
2025-06-01 23:00:00,120,Tláhuac,19.2978,-99.0123,L12,222,211,433,23
2025-06-07 02:00:00,10,Centro,19.4326,-99.1332,L1,126,118,244,2
2025-06-13 13:00:00,120,Tláhuac,19.2978,-99.0123,L12,221,223,444,13
2025-06-14 12:00:00,10,Centro,19.4326,-99.1332,L1,103,91,194,12
2025-06-27 15:00:00,10,Centro,19.4326,-99.1332,L1,91,112,203,15
2025-06-17 12:00:00,10,Centro,19.4326,-99.1332,L1,108,108,216,12
2025-06-04 14:00:00,200,Estadio_Azteca,19.302,-99.15,NA,176,181,357,14
2025-06-06 16:00:00,120,Tláhuac,19.2978,-99.0123,L12,220,235,455,16
2025-06-27 05:00:00,10,Centro,19.4326,-99.1332,L1,101,108,209,5
2025-06-06 02:00:00,10,Centro,19.4326,-99.1332,L1,91,106,197,2
2025-06-05 14:00:00,10,Centro,19.4326,-99.1332,L1,99,89,188,14
2025-06-23 17:00:00,10,Centro,19.4326,-99.1332,L1,360,440,800,17
2025-06-13 17:00:00,200,Estadio_Azteca,19.302,-99.15,NA,736,723,1459,17
2025-06-15 18:00:00,10,Centro,19.4326,-99.1332,L1,357,431,788,18
2025-06-23 18:00:00,10,Centro,19.4326,-99.1332,L1,436,400,836,18
2025-06-13 09:00:00,120,Tláhuac,19.2978,-99.0123,L12,227,223,450,9
2025-06-14 09:00:00,200,Estadio_Azteca,19.302,-99.15,NA,194,163,357,9
2025-06-28 10:00:00,120,Tláhuac,19.2978,-99.0123,L12,211,254,465,10
2025-06-11 05:00:00,200,Estadio_Azteca,19.302,-99.15,NA,179,180,359,5
2025-06-27 02:00:00,10,Centro,19.4326,-99.1332,L1,98,110,208,2
2025-06-09 19:00:00,200,Estadio_Azteca,19.302,-99.15,NA,736,648,1384,19
2025-06-04 07:00:00,10,Centro,19.4326,-99.1332,L1,382,323,705,7
2025-06-02 09:00:00,120,Tláhuac,19.2978,-99.0123,L12,222,202,424,9
2025-06-19 21:00:00,10,Centro,19.4326,-99.1332,L1,120,99,219,21
2025-06-21 08:00:00,200,Estadio_Azteca,19.302,-99.15,NA,721,625,1346,8
2025-06-07 06:00:00,120,Tláhuac,19.2978,-99.0123,L12,227,202,429,6
2025-06-23 21:00:00,10,Centro,19.4326,-99.1332,L1,99,97,196,21
2025-06-09 01:00:00,120,Tláhuac,19.2978,-99.0123,L12,200,232,432,1
2025-06-06 23:00:00,200,Estadio_Azteca,19.302,-99.15,NA,163,179,342,23
2025-06-13 15:00:00,120,Tláhuac,19.2978,-99.0123,L12,235,205,440,15
2025-06-14 02:00:00,10,Centro,19.4326,-99.1332,L1,91,105,196,2
2025-06-12 13:00:00,120,Tláhuac,19.2978,-99.0123,L12,210,212,422,13
2025-06-07 04:00:00,200,Estadio_Azteca,19.302,-99.15,NA,204,191,395,4
2025-06-02 17:00:00,200,Estadio_Azteca,19.302,-99.15,NA,771,657,1428,17
2025-06-25 15:00:00,200,Estadio_Azteca,19.302,-99.15,NA,163,192,355,15
2025-06-03 13:00:00,10,Centro,19.4326,-99.1332,L1,100,111,211,13
2025-06-04 22:00:00,120,Tláhuac,19.2978,-99.0123,L12,188,229,417,22
2025-06-15 16:00:00,10,Centro,19.4326,-99.1332,L1,91,94,185,16
2025-06-01 21:00:00,10,Centro,19.4326,-99.1332,L1,98,90,188,21
2025-06-06 07:00:00,200,Estadio_Azteca,19.302,-99.15,NA,567,624,1191,7
2025-06-10 20:00:00,10,Centro,19.4326,-99.1332,L1,94,110,204,20
2025-06-10 15:00:00,200,Estadio_Azteca,19.302,-99.15,NA,174,193,367,15
2025-06-21 16:00:00,200,Estadio_Azteca,19.302,-99.15,NA,183,157,340,16
2025-06-13 09:00:00,10,Centro,19.4326,-99.1332,L1,92,111,203,9
2025-06-14 16:00:00,10,Centro,19.4326,-99.1332,L1,82,94,176,16
2025-06-07 17:00:00,10,Centro,19.4326,-99.1332,L1,384,374,758,17
2025-06-24 21:00:00,120,Tláhuac,19.2978,-99.0123,L12,206,242,448,21
2025-06-09 04:00:00,10,Centro,19.4326,-99.1332,L1,90,81,171,4
2025-06-28 13:00:00,10,Centro,19.4326,-99.1332,L1,99,99,198,13
2025-06-13 07:00:00,200,Estadio_Azteca,19.302,-99.15,NA,633,653,1286,7
2025-06-12 21:00:00,10,Centro,19.4326,-99.1332,L1,91,103,194,21
2025-06-12 05:00:00,120,Tláhuac,19.2978,-99.0123,L12,196,236,432,5
2025-06-03 22:00:00,10,Centro,19.4326,-99.1332,L1,96,103,199,22
2025-06-29 16:00:00,10,Centro,19.4326,-99.1332,L1,101,109,210,16
2025-06-06 15:00:00,200,Estadio_Azteca,19.302,-99.15,NA,156,186,342,15
2025-06-23 06:00:00,120,Tláhuac,19.2978,-99.0123,L12,197,204,401,6
2025-06-05 03:00:00,10,Centro,19.4326,-99.1332,L1,98,102,200,3
2025-06-18 03:00:00,10,Centro,19.4326,-99.1332,L1,112,105,217,3
2025-06-18 15:00:00,200,Estadio_Azteca,19.302,-99.15,NA,171,199,370,15
2025-06-12 16:00:00,200,Estadio_Azteca,19.302,-99.15,NA,194,163,357,16
2025-06-12 19:00:00,120,Tláhuac,19.2978,-99.0123,L12,880,849,1729,19
2025-06-25 04:00:00,120,Tláhuac,19.2978,-99.0123,L12,193,220,413,4
2025-06-03 22:00:00,120,Tláhuac,19.2978,-99.0123,L12,203,226,429,22
2025-06-22 03:00:00,120,Tláhuac,19.2978,-99.0123,L12,211,204,415,3
2025-06-27 00:00:00,120,Tláhuac,19.2978,-99.0123,L12,197,237,434,0
2025-06-22 09:00:00,200,Estadio_Azteca,19.302,-99.15,NA,183,184,367,9
2025-06-19 03:00:00,10,Centro,19.4326,-99.1332,L1,106,116,222,3
2025-06-04 01:00:00,200,Estadio_Azteca,19.302,-99.15,NA,174,180,354,1
2025-06-26 19:00:00,10,Centro,19.4326,-99.1332,L1,374,409,783,19
2025-06-04 07:00:00,120,Tláhuac,19.2978,-99.0123,L12,827,799,1626,7
2025-06-13 14:00:00,120,Tláhuac,19.2978,-99.0123,L12,241,223,464,14
2025-06-08 08:00:00,200,Estadio_Azteca,19.302,-99.15,NA,601,624,1225,8
2025-06-24 00:00:00,120,Tláhuac,19.2978,-99.0123,L12,217,214,431,0
2025-06-29 11:00:00,200,Estadio_Azteca,19.302,-99.15,NA,157,192,349,11
2025-06-12 15:00:00,200,Estadio_Azteca,19.302,-99.15,NA,187,159,346,15
2025-06-05 05:00:00,120,Tláhuac,19.2978,-99.0123,L12,204,210,414,5
2025-06-17 07:00:00,120,Tláhuac,19.2978,-99.0123,L12,740,879,1619,7
2025-06-06 18:00:00,120,Tláhuac,19.2978,-99.0123,L12,928,847,1775,18
2025-06-01 04:00:00,200,Estadio_Azteca,19.302,-99.15,NA,169,192,361,4
2025-06-19 12:00:00,10,Centro,19.4326,-99.1332,L1,90,105,195,12
2025-06-05 02:00:00,10,Centro,19.4326,-99.1332,L1,101,103,204,2
2025-06-23 15:00:00,200,Estadio_Azteca,19.302,-99.15,NA,195,188,383,15
2025-06-09 23:00:00,10,Centro,19.4326,-99.1332,L1,88,109,197,23
2025-06-19 12:00:00,200,Estadio_Azteca,19.302,-99.15,NA,176,178,354,12
2025-06-17 04:00:00,200,Estadio_Azteca,19.302,-99.15,NA,169,190,359,4
2025-06-28 00:00:00,10,Centro,19.4326,-99.1332,L1,101,116,217,0
2025-06-24 05:00:00,120,Tláhuac,19.2978,-99.0123,L12,231,199,430,5
2025-06-12 22:00:00,200,Estadio_Azteca,19.302,-99.15,NA,175,207,382,22
2025-06-17 15:00:00,200,Estadio_Azteca,19.302,-99.15,NA,171,178,349,15
2025-06-06 22:00:00,200,Estadio_Azteca,19.302,-99.15,NA,177,162,339,22
2025-06-13 17:00:00,120,Tláhuac,19.2978,-99.0123,L12,814,992,1806,17
2025-06-13 22:00:00,200,Estadio_Azteca,19.302,-99.15,NA,190,158,348,22
2025-06-27 17:00:00,200,Estadio_Azteca,19.302,-99.15,NA,684,760,1444,17
2025-06-05 21:00:00,10,Centro,19.4326,-99.1332,L1,94,87,181,21
2025-06-16 06:00:00,10,Centro,19.4326,-99.1332,L1,116,99,215,6
2025-06-11 08:00:00,120,Tláhuac,19.2978,-99.0123,L12,729,804,1533,8
2025-06-06 22:00:00,120,Tláhuac,19.2978,-99.0123,L12,208,239,447,22
2025-06-12 23:00:00,120,Tláhuac,19.2978,-99.0123,L12,215,235,450,23
2025-06-28 07:00:00,120,Tláhuac,19.2978,-99.0123,L12,741,747,1488,7
2025-06-05 09:00:00,200,Estadio_Azteca,19.302,-99.15,NA,162,161,323,9
2025-06-28 22:00:00,10,Centro,19.4326,-99.1332,L1,106,101,207,22
2025-06-02 11:00:00,120,Tláhuac,19.2978,-99.0123,L12,239,209,448,11
2025-06-16 07:00:00,200,Estadio_Azteca,19.302,-99.15,NA,630,616,1246,7
2025-06-02 16:00:00,200,Estadio_Azteca,19.302,-99.15,NA,187,169,356,16
2025-06-15 12:00:00,120,Tláhuac,19.2978,-99.0123,L12,220,239,459,12
2025-06-28 01:00:00,10,Centro,19.4326,-99.1332,L1,94,105,199,1
2025-06-22 16:00:00,200,Estadio_Azteca,19.302,-99.15,NA,182,185,367,16
2025-06-14 01:00:00,120,Tláhuac,19.2978,-99.0123,L12,222,187,409,1
2025-06-19 05:00:00,10,Centro,19.4326,-99.1332,L1,123,106,229,5
2025-06-26 06:00:00,10,Centro,19.4326,-99.1332,L1,102,97,199,6
2025-06-02 14:00:00,200,Estadio_Azteca,19.302,-99.15,NA,180,167,347,14
2025-06-02 01:00:00,200,Estadio_Azteca,19.302,-99.15,NA,178,205,383,1
2025-06-08 01:00:00,120,Tláhuac,19.2978,-99.0123,L12,220,221,441,1
2025-06-22 15:00:00,120,Tláhuac,19.2978,-99.0123,L12,195,191,386,15
2025-06-28 11:00:00,120,Tláhuac,19.2978,-99.0123,L12,196,220,416,11
2025-06-27 13:00:00,120,Tláhuac,19.2978,-99.0123,L12,230,199,429,13
2025-06-28 16:00:00,10,Centro,19.4326,-99.1332,L1,104,91,195,16
2025-06-24 23:00:00,120,Tláhuac,19.2978,-99.0123,L12,194,223,417,23
2025-06-18 22:00:00,120,Tláhuac,19.2978,-99.0123,L12,223,233,456,22
2025-06-11 12:00:00,120,Tláhuac,19.2978,-99.0123,L12,223,216,439,12
2025-06-25 19:00:00,200,Estadio_Azteca,19.302,-99.15,NA,728,710,1438,19
2025-06-10 15:00:00,10,Centro,19.4326,-99.1332,L1,88,106,194,15
2025-06-09 09:00:00,10,Centro,19.4326,-99.1332,L1,104,96,200,9
2025-06-21 00:00:00,10,Centro,19.4326,-99.1332,L1,94,87,181,0
2025-06-09 02:00:00,120,Tláhuac,19.2978,-99.0123,L12,229,240,469,2
2025-06-29 23:00:00,200,Estadio_Azteca,19.302,-99.15,NA,184,176,360,23
2025-06-22 11:00:00,10,Centro,19.4326,-99.1332,L1,87,106,193,11
2025-06-12 06:00:00,120,Tláhuac,19.2978,-99.0123,L12,206,232,438,6
2025-06-13 09:00:00,200,Estadio_Azteca,19.302,-99.15,NA,196,176,372,9
2025-06-30 16:00:00,10,Centro,19.4326,-99.1332,L1,94,104,198,16
2025-06-29 22:00:00,200,Estadio_Azteca,19.302,-99.15,NA,178,212,390,22
2025-06-19 06:00:00,10,Centro,19.4326,-99.1332,L1,104,99,203,6
2025-06-12 08:00:00,200,Estadio_Azteca,19.302,-99.15,NA,633,666,1299,8
2025-06-26 08:00:00,200,Estadio_Azteca,19.302,-99.15,NA,580,685,1265,8
2025-06-20 12:00:00,120,Tláhuac,19.2978,-99.0123,L12,253,211,464,12
2025-06-08 16:00:00,10,Centro,19.4326,-99.1332,L1,93,113,206,16
2025-06-09 12:00:00,200,Estadio_Azteca,19.302,-99.15,NA,165,171,336,12
2025-06-14 21:00:00,120,Tláhuac,19.2978,-99.0123,L12,202,199,401,21
2025-06-27 21:00:00,200,Estadio_Azteca,19.302,-99.15,NA,179,163,342,21
2025-06-16 10:00:00,200,Estadio_Azteca,19.302,-99.15,NA,166,192,358,10
2025-06-09 08:00:00,10,Centro,19.4326,-99.1332,L1,344,391,735,8
2025-06-27 00:00:00,10,Centro,19.4326,-99.1332,L1,101,99,200,0
2025-06-23 13:00:00,10,Centro,19.4326,-99.1332,L1,104,88,192,13
2025-06-29 09:00:00,10,Centro,19.4326,-99.1332,L1,97,96,193,9
2025-06-17 11:00:00,10,Centro,19.4326,-99.1332,L1,114,101,215,11
2025-06-20 17:00:00,120,Tláhuac,19.2978,-99.0123,L12,865,849,1714,17
2025-06-21 14:00:00,200,Estadio_Azteca,19.302,-99.15,NA,170,197,367,14
2025-06-18 20:00:00,10,Centro,19.4326,-99.1332,L1,101,107,208,20
2025-06-01 21:00:00,120,Tláhuac,19.2978,-99.0123,L12,215,201,416,21
2025-06-06 16:00:00,200,Estadio_Azteca,19.302,-99.15,NA,160,193,353,16
2025-06-10 10:00:00,200,Estadio_Azteca,19.302,-99.15,NA,158,191,349,10
2025-06-15 03:00:00,200,Estadio_Azteca,19.302,-99.15,NA,172,164,336,3
2025-06-18 08:00:00,200,Estadio_Azteca,19.302,-99.15,NA,609,634,1243,8
2025-06-21 05:00:00,10,Centro,19.4326,-99.1332,L1,89,97,186,5
2025-06-19 02:00:00,200,Estadio_Azteca,19.302,-99.15,NA,170,203,373,2
2025-06-27 10:00:00,120,Tláhuac,19.2978,-99.0123,L12,254,210,464,10
2025-06-15 21:00:00,10,Centro,19.4326,-99.1332,L1,92,95,187,21
2025-06-28 10:00:00,200,Estadio_Azteca,19.302,-99.15,NA,199,178,377,10
2025-06-07 00:00:00,120,Tláhuac,19.2978,-99.0123,L12,190,195,385,0
2025-06-07 00:00:00,200,Estadio_Azteca,19.302,-99.15,NA,198,198,396,0
2025-06-10 10:00:00,120,Tláhuac,19.2978,-99.0123,L12,205,223,428,10
2025-06-03 20:00:00,200,Estadio_Azteca,19.302,-99.15,NA,167,174,341,20
2025-06-12 23:00:00,200,Estadio_Azteca,19.302,-99.15,NA,194,160,354,23
2025-06-09 11:00:00,200,Estadio_Azteca,19.302,-99.15,NA,186,204,390,11
2025-06-06 20:00:00,120,Tláhuac,19.2978,-99.0123,L12,227,189,416,20
2025-06-08 22:00:00,200,Estadio_Azteca,19.302,-99.15,NA,202,183,385,22
2025-06-16 13:00:00,10,Centro,19.4326,-99.1332,L1,90,105,195,13
2025-06-15 00:00:00,200,Estadio_Azteca,19.302,-99.15,NA,172,154,326,0
2025-06-11 22:00:00,120,Tláhuac,19.2978,-99.0123,L12,203,242,445,22
2025-06-01 07:00:00,10,Centro,19.4326,-99.1332,L1,339,324,663,7
2025-06-30 20:00:00,10,Centro,19.4326,-99.1332,L1,99,95,194,20
2025-06-23 23:00:00,120,Tláhuac,19.2978,-99.0123,L12,247,217,464,23
2025-06-17 13:00:00,10,Centro,19.4326,-99.1332,L1,94,102,196,13
2025-06-03 18:00:00,120,Tláhuac,19.2978,-99.0123,L12,802,916,1718,18
2025-06-01 16:00:00,200,Estadio_Azteca,19.302,-99.15,NA,173,168,341,16
2025-06-03 09:00:00,10,Centro,19.4326,-99.1332,L1,94,89,183,9
2025-06-06 16:00:00,10,Centro,19.4326,-99.1332,L1,107,111,218,16
2025-06-16 02:00:00,200,Estadio_Azteca,19.302,-99.15,NA,192,181,373,2
2025-06-21 21:00:00,10,Centro,19.4326,-99.1332,L1,96,102,198,21
2025-06-15 05:00:00,120,Tláhuac,19.2978,-99.0123,L12,217,199,416,5
2025-06-18 15:00:00,10,Centro,19.4326,-99.1332,L1,104,101,205,15
2025-06-09 03:00:00,120,Tláhuac,19.2978,-99.0123,L12,202,205,407,3
2025-06-21 22:00:00,10,Centro,19.4326,-99.1332,L1,114,103,217,22
2025-06-01 23:00:00,10,Centro,19.4326,-99.1332,L1,104,96,200,23
2025-06-18 16:00:00,120,Tláhuac,19.2978,-99.0123,L12,237,215,452,16
2025-06-27 08:00:00,200,Estadio_Azteca,19.302,-99.15,NA,592,701,1293,8
2025-06-08 03:00:00,200,Estadio_Azteca,19.302,-99.15,NA,200,193,393,3
2025-06-10 00:00:00,200,Estadio_Azteca,19.302,-99.15,NA,202,185,387,0
2025-06-19 14:00:00,10,Centro,19.4326,-99.1332,L1,110,120,230,14
2025-06-17 03:00:00,120,Tláhuac,19.2978,-99.0123,L12,236,209,445,3
2025-06-21 03:00:00,10,Centro,19.4326,-99.1332,L1,103,86,189,3
2025-06-28 05:00:00,200,Estadio_Azteca,19.302,-99.15,NA,213,189,402,5
2025-06-03 06:00:00,120,Tláhuac,19.2978,-99.0123,L12,221,220,441,6
2025-06-13 19:00:00,120,Tláhuac,19.2978,-99.0123,L12,847,892,1739,19
2025-06-24 01:00:00,200,Estadio_Azteca,19.302,-99.15,NA,172,206,378,1
2025-06-09 14:00:00,120,Tláhuac,19.2978,-99.0123,L12,223,215,438,14
2025-06-19 17:00:00,120,Tláhuac,19.2978,-99.0123,L12,936,780,1716,17
2025-06-04 13:00:00,200,Estadio_Azteca,19.302,-99.15,NA,161,182,343,13
2025-06-21 06:00:00,10,Centro,19.4326,-99.1332,L1,82,89,171,6
2025-06-08 13:00:00,120,Tláhuac,19.2978,-99.0123,L12,224,223,447,13
2025-06-16 22:00:00,120,Tláhuac,19.2978,-99.0123,L12,224,216,440,22
2025-06-07 02:00:00,120,Tláhuac,19.2978,-99.0123,L12,199,215,414,2
2025-06-13 12:00:00,120,Tláhuac,19.2978,-99.0123,L12,200,226,426,12
2025-06-23 09:00:00,10,Centro,19.4326,-99.1332,L1,92,90,182,9
2025-06-01 06:00:00,10,Centro,19.4326,-99.1332,L1,95,117,212,6
2025-06-11 21:00:00,10,Centro,19.4326,-99.1332,L1,108,112,220,21
2025-06-25 16:00:00,120,Tláhuac,19.2978,-99.0123,L12,200,229,429,16
2025-06-06 07:00:00,120,Tláhuac,19.2978,-99.0123,L12,764,768,1532,7
2025-06-18 06:00:00,120,Tláhuac,19.2978,-99.0123,L12,226,229,455,6
2025-06-26 01:00:00,10,Centro,19.4326,-99.1332,L1,86,107,193,1
2025-06-26 21:00:00,10,Centro,19.4326,-99.1332,L1,91,93,184,21
2025-06-15 23:00:00,200,Estadio_Azteca,19.302,-99.15,NA,174,196,370,23
2025-06-30 16:00:00,120,Tláhuac,19.2978,-99.0123,L12,223,210,433,16
2025-06-14 23:00:00,120,Tláhuac,19.2978,-99.0123,L12,213,190,403,23
2025-06-16 17:00:00,200,Estadio_Azteca,19.302,-99.15,NA,694,740,1434,17
2025-06-18 00:00:00,200,Estadio_Azteca,19.302,-99.15,NA,164,174,338,0
2025-06-28 23:00:00,200,Estadio_Azteca,19.302,-99.15,NA,172,156,328,23
2025-06-26 09:00:00,200,Estadio_Azteca,19.302,-99.15,NA,200,185,385,9
2025-06-16 01:00:00,10,Centro,19.4326,-99.1332,L1,105,93,198,1
2025-06-23 23:00:00,10,Centro,19.4326,-99.1332,L1,109,124,233,23
2025-06-06 04:00:00,10,Centro,19.4326,-99.1332,L1,96,91,187,4
2025-06-04 18:00:00,120,Tláhuac,19.2978,-99.0123,L12,782,952,1734,18
2025-06-30 13:00:00,10,Centro,19.4326,-99.1332,L1,87,108,195,13
2025-06-23 11:00:00,10,Centro,19.4326,-99.1332,L1,108,90,198,11
2025-06-10 22:00:00,200,Estadio_Azteca,19.302,-99.15,NA,158,194,352,22
2025-06-20 06:00:00,120,Tláhuac,19.2978,-99.0123,L12,244,206,450,6
2025-06-07 16:00:00,120,Tláhuac,19.2978,-99.0123,L12,190,231,421,16
2025-06-25 20:00:00,10,Centro,19.4326,-99.1332,L1,121,102,223,20
2025-06-06 23:00:00,120,Tláhuac,19.2978,-99.0123,L12,246,214,460,23
2025-06-01 08:00:00,200,Estadio_Azteca,19.302,-99.15,NA,638,604,1242,8
2025-06-21 02:00:00,10,Centro,19.4326,-99.1332,L1,99,94,193,2
2025-06-22 14:00:00,10,Centro,19.4326,-99.1332,L1,106,110,216,14
2025-06-29 01:00:00,200,Estadio_Azteca,19.302,-99.15,NA,159,186,345,1
2025-06-02 02:00:00,120,Tláhuac,19.2978,-99.0123,L12,227,217,444,2
2025-06-06 02:00:00,120,Tláhuac,19.2978,-99.0123,L12,227,212,439,2
2025-06-21 03:00:00,120,Tláhuac,19.2978,-99.0123,L12,236,204,440,3
2025-06-01 10:00:00,10,Centro,19.4326,-99.1332,L1,90,98,188,10
2025-06-18 14:00:00,120,Tláhuac,19.2978,-99.0123,L12,200,228,428,14
2025-06-12 02:00:00,120,Tláhuac,19.2978,-99.0123,L12,212,224,436,2
2025-06-08 09:00:00,200,Estadio_Azteca,19.302,-99.15,NA,188,187,375,9
2025-06-28 19:00:00,10,Centro,19.4326,-99.1332,L1,383,378,761,19
2025-06-29 12:00:00,10,Centro,19.4326,-99.1332,L1,101,118,219,12
2025-06-16 01:00:00,120,Tláhuac,19.2978,-99.0123,L12,225,215,440,1
2025-06-30 19:00:00,10,Centro,19.4326,-99.1332,L1,423,379,802,19
2025-06-08 19:00:00,120,Tláhuac,19.2978,-99.0123,L12,945,833,1778,19
2025-06-03 06:00:00,200,Estadio_Azteca,19.302,-99.15,NA,193,190,383,6
2025-06-03 19:00:00,10,Centro,19.4326,-99.1332,L1,411,403,814,19
2025-06-13 01:00:00,10,Centro,19.4326,-99.1332,L1,88,97,185,1
2025-06-14 01:00:00,200,Estadio_Azteca,19.302,-99.15,NA,175,199,374,1
2025-06-09 04:00:00,120,Tláhuac,19.2978,-99.0123,L12,215,236,451,4
2025-06-16 13:00:00,200,Estadio_Azteca,19.302,-99.15,NA,180,160,340,13
2025-06-05 05:00:00,10,Centro,19.4326,-99.1332,L1,108,102,210,5
2025-06-23 01:00:00,120,Tláhuac,19.2978,-99.0123,L12,213,219,432,1
2025-06-09 01:00:00,10,Centro,19.4326,-99.1332,L1,101,93,194,1
2025-06-18 02:00:00,200,Estadio_Azteca,19.302,-99.15,NA,187,184,371,2
2025-06-30 17:00:00,10,Centro,19.4326,-99.1332,L1,374,393,767,17
2025-06-03 16:00:00,120,Tláhuac,19.2978,-99.0123,L12,210,249,459,16
2025-06-14 18:00:00,120,Tláhuac,19.2978,-99.0123,L12,824,923,1747,18
2025-06-25 01:00:00,120,Tláhuac,19.2978,-99.0123,L12,209,219,428,1
2025-06-24 11:00:00,200,Estadio_Azteca,19.302,-99.15,NA,175,206,381,11
2025-06-14 20:00:00,200,Estadio_Azteca,19.302,-99.15,NA,184,158,342,20
2025-06-22 10:00:00,10,Centro,19.4326,-99.1332,L1,99,98,197,10
2025-06-19 21:00:00,120,Tláhuac,19.2978,-99.0123,L12,222,221,443,21
2025-06-22 21:00:00,120,Tláhuac,19.2978,-99.0123,L12,191,231,422,21
2025-06-04 00:00:00,10,Centro,19.4326,-99.1332,L1,95,89,184,0
2025-06-21 20:00:00,200,Estadio_Azteca,19.302,-99.15,NA,183,168,351,20
2025-06-30 12:00:00,120,Tláhuac,19.2978,-99.0123,L12,230,256,486,12
2025-06-07 17:00:00,120,Tláhuac,19.2978,-99.0123,L12,837,870,1707,17
2025-06-05 21:00:00,120,Tláhuac,19.2978,-99.0123,L12,236,215,451,21
2025-06-29 19:00:00,10,Centro,19.4326,-99.1332,L1,392,375,767,19
2025-06-18 07:00:00,10,Centro,19.4326,-99.1332,L1,353,353,706,7
2025-06-20 00:00:00,120,Tláhuac,19.2978,-99.0123,L12,215,210,425,0
2025-06-18 12:00:00,200,Estadio_Azteca,19.302,-99.15,NA,158,194,352,12
2025-06-21 10:00:00,10,Centro,19.4326,-99.1332,L1,101,91,192,10
2025-06-17 23:00:00,200,Estadio_Azteca,19.302,-99.15,NA,170,178,348,23
2025-06-11 20:00:00,200,Estadio_Azteca,19.302,-99.15,NA,166,182,348,20
2025-06-01 19:00:00,10,Centro,19.4326,-99.1332,L1,444,398,842,19
2025-06-06 17:00:00,120,Tláhuac,19.2978,-99.0123,L12,960,828,1788,17
2025-06-23 02:00:00,10,Centro,19.4326,-99.1332,L1,89,102,191,2
2025-06-17 22:00:00,10,Centro,19.4326,-99.1332,L1,106,102,208,22
2025-06-23 19:00:00,200,Estadio_Azteca,19.302,-99.15,NA,677,751,1428,19
2025-06-23 11:00:00,120,Tláhuac,19.2978,-99.0123,L12,240,231,471,11
2025-06-02 00:00:00,200,Estadio_Azteca,19.302,-99.15,NA,191,162,353,0
2025-06-12 00:00:00,120,Tláhuac,19.2978,-99.0123,L12,205,251,456,0
2025-06-24 06:00:00,120,Tláhuac,19.2978,-99.0123,L12,214,214,428,6
2025-06-11 11:00:00,10,Centro,19.4326,-99.1332,L1,100,83,183,11
2025-06-17 01:00:00,10,Centro,19.4326,-99.1332,L1,110,93,203,1
2025-06-23 20:00:00,10,Centro,19.4326,-99.1332,L1,81,87,168,20
2025-06-07 05:00:00,120,Tláhuac,19.2978,-99.0123,L12,231,218,449,5
2025-06-23 15:00:00,120,Tláhuac,19.2978,-99.0123,L12,216,226,442,15
2025-06-22 20:00:00,120,Tláhuac,19.2978,-99.0123,L12,231,197,428,20
2025-06-11 00:00:00,200,Estadio_Azteca,19.302,-99.15,NA,158,155,313,0
2025-06-23 18:00:00,200,Estadio_Azteca,19.302,-99.15,NA,754,734,1488,18
2025-06-11 17:00:00,200,Estadio_Azteca,19.302,-99.15,NA,757,712,1469,17
2025-06-01 15:00:00,120,Tláhuac,19.2978,-99.0123,L12,222,201,423,15
2025-06-16 03:00:00,200,Estadio_Azteca,19.302,-99.15,NA,181,206,387,3
2025-06-05 02:00:00,120,Tláhuac,19.2978,-99.0123,L12,235,215,450,2
2025-06-29 00:00:00,10,Centro,19.4326,-99.1332,L1,85,92,177,0
2025-06-08 10:00:00,200,Estadio_Azteca,19.302,-99.15,NA,194,169,363,10
2025-06-13 01:00:00,120,Tláhuac,19.2978,-99.0123,L12,238,238,476,1
2025-06-07 01:00:00,200,Estadio_Azteca,19.302,-99.15,NA,182,186,368,1
2025-06-08 11:00:00,200,Estadio_Azteca,19.302,-99.15,NA,175,178,353,11
2025-06-06 11:00:00,120,Tláhuac,19.2978,-99.0123,L12,212,240,452,11
2025-06-26 09:00:00,120,Tláhuac,19.2978,-99.0123,L12,194,214,408,9
2025-06-01 10:00:00,120,Tláhuac,19.2978,-99.0123,L12,231,197,428,10
2025-06-22 15:00:00,10,Centro,19.4326,-99.1332,L1,82,97,179,15
2025-06-13 05:00:00,120,Tláhuac,19.2978,-99.0123,L12,232,220,452,5
2025-06-16 08:00:00,200,Estadio_Azteca,19.302,-99.15,NA,622,685,1307,8
2025-06-26 00:00:00,120,Tláhuac,19.2978,-99.0123,L12,234,224,458,0
2025-06-17 18:00:00,10,Centro,19.4326,-99.1332,L1,372,409,781,18
2025-06-14 02:00:00,120,Tláhuac,19.2978,-99.0123,L12,220,214,434,2
2025-06-05 18:00:00,10,Centro,19.4326,-99.1332,L1,389,363,752,18
2025-06-20 18:00:00,120,Tláhuac,19.2978,-99.0123,L12,831,974,1805,18
2025-06-05 21:00:00,200,Estadio_Azteca,19.302,-99.15,NA,181,157,338,21
2025-06-02 06:00:00,200,Estadio_Azteca,19.302,-99.15,NA,165,163,328,6
2025-06-24 07:00:00,120,Tláhuac,19.2978,-99.0123,L12,825,739,1564,7
2025-06-23 14:00:00,10,Centro,19.4326,-99.1332,L1,103,95,198,14
2025-06-13 03:00:00,120,Tláhuac,19.2978,-99.0123,L12,216,219,435,3
2025-06-30 19:00:00,200,Estadio_Azteca,19.302,-99.15,NA,814,683,1497,19
2025-06-04 15:00:00,120,Tláhuac,19.2978,-99.0123,L12,227,191,418,15
2025-06-11 13:00:00,120,Tláhuac,19.2978,-99.0123,L12,235,204,439,13
2025-06-08 14:00:00,10,Centro,19.4326,-99.1332,L1,100,94,194,14
2025-06-08 17:00:00,120,Tláhuac,19.2978,-99.0123,L12,929,843,1772,17
2025-06-11 22:00:00,200,Estadio_Azteca,19.302,-99.15,NA,192,178,370,22
2025-06-12 14:00:00,10,Centro,19.4326,-99.1332,L1,107,96,203,14
2025-06-11 14:00:00,10,Centro,19.4326,-99.1332,L1,101,97,198,14
2025-06-13 22:00:00,10,Centro,19.4326,-99.1332,L1,93,111,204,22
2025-06-20 02:00:00,200,Estadio_Azteca,19.302,-99.15,NA,183,175,358,2
2025-06-05 04:00:00,120,Tláhuac,19.2978,-99.0123,L12,224,200,424,4
2025-06-25 03:00:00,200,Estadio_Azteca,19.302,-99.15,NA,151,179,330,3
2025-06-27 14:00:00,120,Tláhuac,19.2978,-99.0123,L12,214,225,439,14
2025-06-05 09:00:00,120,Tláhuac,19.2978,-99.0123,L12,236,216,452,9
2025-06-22 18:00:00,120,Tláhuac,19.2978,-99.0123,L12,812,955,1767,18
2025-06-07 07:00:00,120,Tláhuac,19.2978,-99.0123,L12,792,733,1525,7
2025-06-03 10:00:00,200,Estadio_Azteca,19.302,-99.15,NA,167,192,359,10
2025-06-10 01:00:00,120,Tláhuac,19.2978,-99.0123,L12,212,230,442,1
2025-06-13 13:00:00,10,Centro,19.4326,-99.1332,L1,95,115,210,13
2025-06-26 15:00:00,200,Estadio_Azteca,19.302,-99.15,NA,174,183,357,15
2025-06-02 17:00:00,120,Tláhuac,19.2978,-99.0123,L12,973,832,1805,17
2025-06-09 07:00:00,10,Centro,19.4326,-99.1332,L1,311,378,689,7
2025-06-06 11:00:00,200,Estadio_Azteca,19.302,-99.15,NA,174,165,339,11
2025-06-14 17:00:00,200,Estadio_Azteca,19.302,-99.15,NA,694,690,1384,17
2025-06-10 19:00:00,10,Centro,19.4326,-99.1332,L1,413,380,793,19
2025-06-01 13:00:00,120,Tláhuac,19.2978,-99.0123,L12,207,223,430,13
2025-06-07 10:00:00,120,Tláhuac,19.2978,-99.0123,L12,230,261,491,10
2025-06-12 17:00:00,10,Centro,19.4326,-99.1332,L1,370,425,795,17
2025-06-27 11:00:00,10,Centro,19.4326,-99.1332,L1,94,92,186,11
2025-06-05 14:00:00,200,Estadio_Azteca,19.302,-99.15,NA,168,193,361,14
2025-06-03 16:00:00,10,Centro,19.4326,-99.1332,L1,94,103,197,16
2025-06-29 13:00:00,120,Tláhuac,19.2978,-99.0123,L12,217,250,467,13
2025-06-05 11:00:00,200,Estadio_Azteca,19.302,-99.15,NA,185,191,376,11
2025-06-04 16:00:00,10,Centro,19.4326,-99.1332,L1,109,104,213,16
2025-06-23 20:00:00,120,Tláhuac,19.2978,-99.0123,L12,222,207,429,20
2025-06-16 17:00:00,10,Centro,19.4326,-99.1332,L1,418,353,771,17
2025-06-10 19:00:00,120,Tláhuac,19.2978,-99.0123,L12,944,871,1815,19
2025-06-13 08:00:00,200,Estadio_Azteca,19.302,-99.15,NA,720,594,1314,8
2025-06-24 08:00:00,200,Estadio_Azteca,19.302,-99.15,NA,574,625,1199,8
2025-06-29 04:00:00,200,Estadio_Azteca,19.302,-99.15,NA,157,192,349,4
2025-06-17 09:00:00,10,Centro,19.4326,-99.1332,L1,103,116,219,9
2025-06-24 04:00:00,200,Estadio_Azteca,19.302,-99.15,NA,205,187,392,4
2025-06-27 08:00:00,120,Tláhuac,19.2978,-99.0123,L12,733,838,1571,8
2025-06-29 22:00:00,10,Centro,19.4326,-99.1332,L1,98,103,201,22
2025-06-10 10:00:00,10,Centro,19.4326,-99.1332,L1,114,108,222,10
2025-06-08 22:00:00,10,Centro,19.4326,-99.1332,L1,82,102,184,22
2025-06-28 12:00:00,10,Centro,19.4326,-99.1332,L1,92,106,198,12
2025-06-26 04:00:00,200,Estadio_Azteca,19.302,-99.15,NA,182,160,342,4
2025-06-25 07:00:00,120,Tláhuac,19.2978,-99.0123,L12,752,775,1527,7
2025-06-20 12:00:00,10,Centro,19.4326,-99.1332,L1,94,105,199,12
2025-06-13 13:00:00,200,Estadio_Azteca,19.302,-99.15,NA,186,167,353,13
2025-06-21 04:00:00,10,Centro,19.4326,-99.1332,L1,90,98,188,4
2025-06-20 04:00:00,120,Tláhuac,19.2978,-99.0123,L12,211,233,444,4
2025-06-14 13:00:00,200,Estadio_Azteca,19.302,-99.15,NA,196,208,404,13
2025-06-15 14:00:00,120,Tláhuac,19.2978,-99.0123,L12,229,193,422,14
2025-06-09 11:00:00,10,Centro,19.4326,-99.1332,L1,111,100,211,11
2025-06-18 07:00:00,120,Tláhuac,19.2978,-99.0123,L12,716,816,1532,7
2025-06-20 02:00:00,120,Tláhuac,19.2978,-99.0123,L12,208,237,445,2
2025-06-06 01:00:00,10,Centro,19.4326,-99.1332,L1,72,78,150,1
2025-06-27 23:00:00,10,Centro,19.4326,-99.1332,L1,118,102,220,23
2025-06-17 08:00:00,10,Centro,19.4326,-99.1332,L1,348,364,712,8
2025-06-14 02:00:00,200,Estadio_Azteca,19.302,-99.15,NA,188,158,346,2
2025-06-27 10:00:00,200,Estadio_Azteca,19.302,-99.15,NA,170,161,331,10
2025-06-09 02:00:00,200,Estadio_Azteca,19.302,-99.15,NA,159,196,355,2
2025-06-30 08:00:00,120,Tláhuac,19.2978,-99.0123,L12,796,785,1581,8
2025-06-28 18:00:00,10,Centro,19.4326,-99.1332,L1,412,349,761,18
2025-06-12 04:00:00,10,Centro,19.4326,-99.1332,L1,92,105,197,4
2025-06-23 12:00:00,10,Centro,19.4326,-99.1332,L1,77,93,170,12
2025-06-22 15:00:00,200,Estadio_Azteca,19.302,-99.15,NA,175,189,364,15
2025-06-23 04:00:00,10,Centro,19.4326,-99.1332,L1,104,96,200,4
2025-06-11 15:00:00,120,Tláhuac,19.2978,-99.0123,L12,237,241,478,15
2025-06-15 15:00:00,120,Tláhuac,19.2978,-99.0123,L12,203,191,394,15
2025-06-05 10:00:00,120,Tláhuac,19.2978,-99.0123,L12,221,248,469,10
2025-06-24 13:00:00,10,Centro,19.4326,-99.1332,L1,100,94,194,13
2025-06-25 13:00:00,120,Tláhuac,19.2978,-99.0123,L12,217,223,440,13
2025-06-17 08:00:00,120,Tláhuac,19.2978,-99.0123,L12,702,824,1526,8
2025-06-11 17:00:00,120,Tláhuac,19.2978,-99.0123,L12,838,968,1806,17
2025-06-25 14:00:00,120,Tláhuac,19.2978,-99.0123,L12,236,195,431,14
2025-06-05 18:00:00,200,Estadio_Azteca,19.302,-99.15,NA,705,707,1412,18
2025-06-06 12:00:00,10,Centro,19.4326,-99.1332,L1,88,105,193,12
2025-06-09 02:00:00,10,Centro,19.4326,-99.1332,L1,108,97,205,2
2025-06-23 22:00:00,120,Tláhuac,19.2978,-99.0123,L12,230,221,451,22
2025-06-05 01:00:00,200,Estadio_Azteca,19.302,-99.15,NA,181,167,348,1
2025-06-13 00:00:00,200,Estadio_Azteca,19.302,-99.15,NA,167,178,345,0
2025-06-15 20:00:00,120,Tláhuac,19.2978,-99.0123,L12,201,219,420,20
2025-06-16 15:00:00,120,Tláhuac,19.2978,-99.0123,L12,208,233,441,15
2025-06-02 23:00:00,120,Tláhuac,19.2978,-99.0123,L12,228,221,449,23
2025-06-21 09:00:00,120,Tláhuac,19.2978,-99.0123,L12,239,202,441,9
2025-06-01 00:00:00,10,Centro,19.4326,-99.1332,L1,92,112,204,0
2025-06-09 00:00:00,120,Tláhuac,19.2978,-99.0123,L12,217,230,447,0
2025-06-19 10:00:00,120,Tláhuac,19.2978,-99.0123,L12,219,216,435,10
2025-06-05 17:00:00,120,Tláhuac,19.2978,-99.0123,L12,840,976,1816,17
2025-06-12 12:00:00,200,Estadio_Azteca,19.302,-99.15,NA,186,191,377,12
2025-06-04 16:00:00,200,Estadio_Azteca,19.302,-99.15,NA,177,166,343,16
2025-06-06 05:00:00,200,Estadio_Azteca,19.302,-99.15,NA,223,194,417,5
2025-06-15 11:00:00,120,Tláhuac,19.2978,-99.0123,L12,227,202,429,11
2025-06-07 02:00:00,200,Estadio_Azteca,19.302,-99.15,NA,192,180,372,2
2025-06-04 18:00:00,200,Estadio_Azteca,19.302,-99.15,NA,623,754,1377,18
2025-06-04 09:00:00,200,Estadio_Azteca,19.302,-99.15,NA,196,189,385,9
2025-06-19 15:00:00,10,Centro,19.4326,-99.1332,L1,92,91,183,15
2025-06-10 12:00:00,10,Centro,19.4326,-99.1332,L1,109,110,219,12
2025-06-15 08:00:00,10,Centro,19.4326,-99.1332,L1,330,391,721,8
2025-06-20 16:00:00,10,Centro,19.4326,-99.1332,L1,97,102,199,16
2025-06-09 10:00:00,200,Estadio_Azteca,19.302,-99.15,NA,173,163,336,10
2025-06-06 18:00:00,200,Estadio_Azteca,19.302,-99.15,NA,752,639,1391,18
2025-06-04 19:00:00,120,Tláhuac,19.2978,-99.0123,L12,881,940,1821,19
2025-06-25 18:00:00,120,Tláhuac,19.2978,-99.0123,L12,883,839,1722,18
2025-06-04 11:00:00,200,Estadio_Azteca,19.302,-99.15,NA,167,169,336,11
2025-06-06 17:00:00,10,Centro,19.4326,-99.1332,L1,380,427,807,17
2025-06-20 21:00:00,10,Centro,19.4326,-99.1332,L1,100,104,204,21
2025-06-25 14:00:00,200,Estadio_Azteca,19.302,-99.15,NA,177,182,359,14
2025-06-05 07:00:00,200,Estadio_Azteca,19.302,-99.15,NA,685,634,1319,7
2025-06-11 08:00:00,10,Centro,19.4326,-99.1332,L1,357,347,704,8
2025-06-30 20:00:00,120,Tláhuac,19.2978,-99.0123,L12,187,226,413,20
2025-06-06 21:00:00,10,Centro,19.4326,-99.1332,L1,102,113,215,21
2025-06-30 02:00:00,10,Centro,19.4326,-99.1332,L1,89,101,190,2
2025-06-20 14:00:00,200,Estadio_Azteca,19.302,-99.15,NA,180,180,360,14
2025-06-14 17:00:00,120,Tláhuac,19.2978,-99.0123,L12,883,937,1820,17
2025-06-22 14:00:00,120,Tláhuac,19.2978,-99.0123,L12,203,179,382,14
2025-06-27 01:00:00,200,Estadio_Azteca,19.302,-99.15,NA,168,197,365,1
2025-06-17 11:00:00,120,Tláhuac,19.2978,-99.0123,L12,218,216,434,11
2025-06-18 04:00:00,200,Estadio_Azteca,19.302,-99.15,NA,173,191,364,4
2025-06-08 07:00:00,200,Estadio_Azteca,19.302,-99.15,NA,622,674,1296,7
2025-06-25 23:00:00,200,Estadio_Azteca,19.302,-99.15,NA,155,178,333,23
2025-06-18 18:00:00,10,Centro,19.4326,-99.1332,L1,412,391,803,18
2025-06-03 12:00:00,10,Centro,19.4326,-99.1332,L1,100,114,214,12
2025-06-03 08:00:00,10,Centro,19.4326,-99.1332,L1,346,353,699,8
2025-06-19 07:00:00,120,Tláhuac,19.2978,-99.0123,L12,838,700,1538,7
2025-06-11 15:00:00,10,Centro,19.4326,-99.1332,L1,88,94,182,15
2025-06-03 14:00:00,200,Estadio_Azteca,19.302,-99.15,NA,179,183,362,14
2025-06-09 14:00:00,200,Estadio_Azteca,19.302,-99.15,NA,163,189,352,14
2025-06-27 07:00:00,200,Estadio_Azteca,19.302,-99.15,NA,707,598,1305,7
2025-06-03 04:00:00,10,Centro,19.4326,-99.1332,L1,107,110,217,4
2025-06-20 08:00:00,10,Centro,19.4326,-99.1332,L1,379,314,693,8
2025-06-04 18:00:00,10,Centro,19.4326,-99.1332,L1,379,392,771,18
2025-06-09 12:00:00,10,Centro,19.4326,-99.1332,L1,87,107,194,12
2025-06-25 17:00:00,120,Tláhuac,19.2978,-99.0123,L12,888,882,1770,17
2025-06-13 14:00:00,200,Estadio_Azteca,19.302,-99.15,NA,182,162,344,14
2025-06-24 03:00:00,120,Tláhuac,19.2978,-99.0123,L12,225,209,434,3
2025-06-06 03:00:00,10,Centro,19.4326,-99.1332,L1,99,84,183,3
2025-06-04 02:00:00,120,Tláhuac,19.2978,-99.0123,L12,215,241,456,2
2025-06-09 05:00:00,10,Centro,19.4326,-99.1332,L1,92,105,197,5
2025-06-14 04:00:00,200,Estadio_Azteca,19.302,-99.15,NA,173,193,366,4
2025-06-22 00:00:00,10,Centro,19.4326,-99.1332,L1,96,106,202,0
2025-06-26 18:00:00,120,Tláhuac,19.2978,-99.0123,L12,826,933,1759,18
2025-06-15 04:00:00,10,Centro,19.4326,-99.1332,L1,112,108,220,4
2025-06-08 04:00:00,10,Centro,19.4326,-99.1332,L1,94,98,192,4
2025-06-21 07:00:00,10,Centro,19.4326,-99.1332,L1,305,346,651,7
2025-06-05 15:00:00,200,Estadio_Azteca,19.302,-99.15,NA,212,174,386,15
2025-06-13 16:00:00,10,Centro,19.4326,-99.1332,L1,95,94,189,16
2025-06-19 13:00:00,120,Tláhuac,19.2978,-99.0123,L12,201,239,440,13
2025-06-17 19:00:00,200,Estadio_Azteca,19.302,-99.15,NA,722,633,1355,19
2025-06-24 12:00:00,10,Centro,19.4326,-99.1332,L1,133,118,251,12
2025-06-01 05:00:00,120,Tláhuac,19.2978,-99.0123,L12,223,254,477,5
2025-06-20 11:00:00,200,Estadio_Azteca,19.302,-99.15,NA,184,158,342,11
2025-06-28 23:00:00,10,Centro,19.4326,-99.1332,L1,114,99,213,23
2025-06-26 04:00:00,120,Tláhuac,19.2978,-99.0123,L12,254,227,481,4
2025-06-27 20:00:00,120,Tláhuac,19.2978,-99.0123,L12,209,214,423,20
2025-06-08 22:00:00,120,Tláhuac,19.2978,-99.0123,L12,221,206,427,22
2025-06-10 02:00:00,120,Tláhuac,19.2978,-99.0123,L12,224,206,430,2
2025-06-30 01:00:00,200,Estadio_Azteca,19.302,-99.15,NA,167,170,337,1
2025-06-16 10:00:00,120,Tláhuac,19.2978,-99.0123,L12,210,213,423,10
2025-06-07 11:00:00,120,Tláhuac,19.2978,-99.0123,L12,203,221,424,11
2025-06-24 11:00:00,10,Centro,19.4326,-99.1332,L1,107,103,210,11
2025-06-03 18:00:00,200,Estadio_Azteca,19.302,-99.15,NA,751,745,1496,18
2025-06-20 03:00:00,200,Estadio_Azteca,19.302,-99.15,NA,207,177,384,3
2025-06-21 05:00:00,200,Estadio_Azteca,19.302,-99.15,NA,157,188,345,5
2025-06-30 13:00:00,120,Tláhuac,19.2978,-99.0123,L12,209,238,447,13
2025-06-15 05:00:00,10,Centro,19.4326,-99.1332,L1,93,96,189,5
2025-06-21 17:00:00,120,Tláhuac,19.2978,-99.0123,L12,812,971,1783,17
2025-06-26 07:00:00,10,Centro,19.4326,-99.1332,L1,361,319,680,7
2025-06-09 05:00:00,120,Tláhuac,19.2978,-99.0123,L12,227,226,453,5
2025-06-30 18:00:00,10,Centro,19.4326,-99.1332,L1,425,427,852,18
2025-06-23 07:00:00,10,Centro,19.4326,-99.1332,L1,351,314,665,7
2025-06-23 14:00:00,120,Tláhuac,19.2978,-99.0123,L12,232,198,430,14
2025-06-22 04:00:00,10,Centro,19.4326,-99.1332,L1,116,101,217,4
2025-06-26 11:00:00,120,Tláhuac,19.2978,-99.0123,L12,192,220,412,11
2025-06-11 07:00:00,120,Tláhuac,19.2978,-99.0123,L12,739,788,1527,7
2025-06-01 14:00:00,200,Estadio_Azteca,19.302,-99.15,NA,172,188,360,14
2025-06-17 13:00:00,200,Estadio_Azteca,19.302,-99.15,NA,139,171,310,13
2025-06-04 19:00:00,200,Estadio_Azteca,19.302,-99.15,NA,718,694,1412,19
2025-06-18 11:00:00,10,Centro,19.4326,-99.1332,L1,100,106,206,11
2025-06-02 09:00:00,10,Centro,19.4326,-99.1332,L1,96,113,209,9
2025-06-25 07:00:00,200,Estadio_Azteca,19.302,-99.15,NA,659,595,1254,7
2025-06-26 10:00:00,10,Centro,19.4326,-99.1332,L1,92,89,181,10
2025-06-16 19:00:00,120,Tláhuac,19.2978,-99.0123,L12,922,835,1757,19
2025-06-02 11:00:00,10,Centro,19.4326,-99.1332,L1,104,102,206,11
2025-06-22 01:00:00,10,Centro,19.4326,-99.1332,L1,115,106,221,1
2025-06-07 21:00:00,10,Centro,19.4326,-99.1332,L1,95,103,198,21
2025-06-30 20:00:00,200,Estadio_Azteca,19.302,-99.15,NA,168,192,360,20
2025-06-21 11:00:00,120,Tláhuac,19.2978,-99.0123,L12,211,244,455,11
2025-06-14 19:00:00,120,Tláhuac,19.2978,-99.0123,L12,842,873,1715,19
2025-06-12 06:00:00,10,Centro,19.4326,-99.1332,L1,95,87,182,6
2025-06-16 09:00:00,120,Tláhuac,19.2978,-99.0123,L12,201,214,415,9
2025-06-18 15:00:00,120,Tláhuac,19.2978,-99.0123,L12,221,207,428,15
2025-06-29 18:00:00,10,Centro,19.4326,-99.1332,L1,400,373,773,18
2025-06-27 18:00:00,120,Tláhuac,19.2978,-99.0123,L12,833,922,1755,18
2025-06-12 05:00:00,200,Estadio_Azteca,19.302,-99.15,NA,200,176,376,5
2025-06-16 17:00:00,120,Tláhuac,19.2978,-99.0123,L12,795,942,1737,17
2025-06-10 21:00:00,200,Estadio_Azteca,19.302,-99.15,NA,175,159,334,21
2025-06-02 00:00:00,120,Tláhuac,19.2978,-99.0123,L12,219,207,426,0
2025-06-23 07:00:00,200,Estadio_Azteca,19.302,-99.15,NA,611,692,1303,7
2025-06-21 16:00:00,10,Centro,19.4326,-99.1332,L1,87,106,193,16
2025-06-19 13:00:00,200,Estadio_Azteca,19.302,-99.15,NA,195,169,364,13
2025-06-21 08:00:00,120,Tláhuac,19.2978,-99.0123,L12,723,858,1581,8
2025-06-07 16:00:00,200,Estadio_Azteca,19.302,-99.15,NA,185,183,368,16
2025-06-18 01:00:00,200,Estadio_Azteca,19.302,-99.15,NA,190,194,384,1
2025-06-08 00:00:00,10,Centro,19.4326,-99.1332,L1,99,97,196,0
2025-06-15 10:00:00,10,Centro,19.4326,-99.1332,L1,95,78,173,10
2025-06-15 09:00:00,200,Estadio_Azteca,19.302,-99.15,NA,156,189,345,9
2025-06-28 21:00:00,120,Tláhuac,19.2978,-99.0123,L12,225,207,432,21
2025-06-30 22:00:00,120,Tláhuac,19.2978,-99.0123,L12,224,212,436,22
2025-06-30 00:00:00,10,Centro,19.4326,-99.1332,L1,104,88,192,0
2025-06-21 23:00:00,10,Centro,19.4326,-99.1332,L1,87,82,169,23
2025-06-25 23:00:00,120,Tláhuac,19.2978,-99.0123,L12,228,222,450,23
2025-06-16 00:00:00,120,Tláhuac,19.2978,-99.0123,L12,214,253,467,0
2025-06-05 07:00:00,10,Centro,19.4326,-99.1332,L1,374,310,684,7
2025-06-15 17:00:00,10,Centro,19.4326,-99.1332,L1,393,410,803,17
2025-06-06 15:00:00,120,Tláhuac,19.2978,-99.0123,L12,249,205,454,15
2025-06-26 16:00:00,200,Estadio_Azteca,19.302,-99.15,NA,190,186,376,16
2025-06-14 19:00:00,200,Estadio_Azteca,19.302,-99.15,NA,749,740,1489,19
2025-06-17 14:00:00,10,Centro,19.4326,-99.1332,L1,105,99,204,14
2025-06-17 23:00:00,120,Tláhuac,19.2978,-99.0123,L12,229,196,425,23
2025-06-19 04:00:00,200,Estadio_Azteca,19.302,-99.15,NA,198,167,365,4
2025-06-05 07:00:00,120,Tláhuac,19.2978,-99.0123,L12,815,795,1610,7
2025-06-04 03:00:00,200,Estadio_Azteca,19.302,-99.15,NA,172,164,336,3
2025-06-11 07:00:00,10,Centro,19.4326,-99.1332,L1,374,329,703,7
2025-06-28 01:00:00,200,Estadio_Azteca,19.302,-99.15,NA,205,170,375,1
2025-06-14 00:00:00,200,Estadio_Azteca,19.302,-99.15,NA,174,192,366,0
2025-06-20 15:00:00,120,Tláhuac,19.2978,-99.0123,L12,254,212,466,15
2025-06-29 13:00:00,10,Centro,19.4326,-99.1332,L1,90,108,198,13
2025-06-26 03:00:00,10,Centro,19.4326,-99.1332,L1,101,120,221,3
2025-06-28 01:00:00,120,Tláhuac,19.2978,-99.0123,L12,235,200,435,1
2025-06-03 01:00:00,200,Estadio_Azteca,19.302,-99.15,NA,171,187,358,1
2025-06-29 06:00:00,10,Centro,19.4326,-99.1332,L1,107,91,198,6
2025-06-14 01:00:00,10,Centro,19.4326,-99.1332,L1,105,99,204,1
2025-06-05 01:00:00,120,Tláhuac,19.2978,-99.0123,L12,218,228,446,1
2025-06-10 14:00:00,10,Centro,19.4326,-99.1332,L1,108,91,199,14
2025-06-10 18:00:00,10,Centro,19.4326,-99.1332,L1,380,380,760,18
2025-06-15 14:00:00,10,Centro,19.4326,-99.1332,L1,108,106,214,14
2025-06-23 09:00:00,120,Tláhuac,19.2978,-99.0123,L12,205,188,393,9
2025-06-08 23:00:00,10,Centro,19.4326,-99.1332,L1,97,90,187,23
2025-06-08 17:00:00,10,Centro,19.4326,-99.1332,L1,371,416,787,17
2025-06-18 14:00:00,10,Centro,19.4326,-99.1332,L1,97,106,203,14
2025-06-10 17:00:00,10,Centro,19.4326,-99.1332,L1,399,388,787,17
2025-06-19 22:00:00,10,Centro,19.4326,-99.1332,L1,95,109,204,22
2025-06-19 09:00:00,120,Tláhuac,19.2978,-99.0123,L12,224,238,462,9
2025-06-19 16:00:00,120,Tláhuac,19.2978,-99.0123,L12,208,195,403,16
2025-06-22 11:00:00,120,Tláhuac,19.2978,-99.0123,L12,233,198,431,11
2025-06-11 09:00:00,200,Estadio_Azteca,19.302,-99.15,NA,197,162,359,9
2025-06-19 11:00:00,200,Estadio_Azteca,19.302,-99.15,NA,157,187,344,11
2025-06-12 08:00:00,10,Centro,19.4326,-99.1332,L1,317,370,687,8
2025-06-03 07:00:00,10,Centro,19.4326,-99.1332,L1,349,358,707,7
2025-06-11 03:00:00,200,Estadio_Azteca,19.302,-99.15,NA,191,165,356,3
2025-06-21 15:00:00,200,Estadio_Azteca,19.302,-99.15,NA,178,171,349,15
2025-06-04 23:00:00,200,Estadio_Azteca,19.302,-99.15,NA,180,156,336,23
2025-06-26 13:00:00,120,Tláhuac,19.2978,-99.0123,L12,223,240,463,13
2025-06-28 11:00:00,10,Centro,19.4326,-99.1332,L1,115,101,216,11
2025-06-09 17:00:00,200,Estadio_Azteca,19.302,-99.15,NA,654,750,1404,17
2025-06-09 07:00:00,200,Estadio_Azteca,19.302,-99.15,NA,593,674,1267,7
2025-06-16 14:00:00,10,Centro,19.4326,-99.1332,L1,92,81,173,14
2025-06-06 05:00:00,10,Centro,19.4326,-99.1332,L1,113,99,212,5
2025-06-27 01:00:00,10,Centro,19.4326,-99.1332,L1,129,115,244,1
2025-06-20 18:00:00,10,Centro,19.4326,-99.1332,L1,412,377,789,18
2025-06-29 09:00:00,200,Estadio_Azteca,19.302,-99.15,NA,194,164,358,9
2025-06-21 20:00:00,10,Centro,19.4326,-99.1332,L1,92,112,204,20
2025-06-20 12:00:00,200,Estadio_Azteca,19.302,-99.15,NA,161,192,353,12
2025-06-22 13:00:00,200,Estadio_Azteca,19.302,-99.15,NA,179,162,341,13
2025-06-01 13:00:00,10,Centro,19.4326,-99.1332,L1,90,99,189,13
2025-06-12 15:00:00,10,Centro,19.4326,-99.1332,L1,102,89,191,15
2025-06-20 02:00:00,10,Centro,19.4326,-99.1332,L1,101,101,202,2
2025-06-15 00:00:00,10,Centro,19.4326,-99.1332,L1,95,107,202,0
2025-06-28 13:00:00,120,Tláhuac,19.2978,-99.0123,L12,194,231,425,13
2025-06-12 16:00:00,120,Tláhuac,19.2978,-99.0123,L12,210,243,453,16
2025-06-09 11:00:00,120,Tláhuac,19.2978,-99.0123,L12,202,224,426,11
2025-06-17 16:00:00,10,Centro,19.4326,-99.1332,L1,102,86,188,16
2025-06-21 18:00:00,120,Tláhuac,19.2978,-99.0123,L12,762,930,1692,18
2025-06-28 16:00:00,200,Estadio_Azteca,19.302,-99.15,NA,177,195,372,16
2025-06-21 19:00:00,10,Centro,19.4326,-99.1332,L1,418,354,772,19
2025-06-25 16:00:00,10,Centro,19.4326,-99.1332,L1,82,101,183,16
2025-06-07 20:00:00,200,Estadio_Azteca,19.302,-99.15,NA,193,176,369,20
2025-06-22 00:00:00,200,Estadio_Azteca,19.302,-99.15,NA,192,175,367,0
2025-06-04 20:00:00,200,Estadio_Azteca,19.302,-99.15,NA,186,216,402,20
2025-06-11 12:00:00,200,Estadio_Azteca,19.302,-99.15,NA,166,187,353,12
2025-06-29 21:00:00,10,Centro,19.4326,-99.1332,L1,92,101,193,21
2025-06-05 23:00:00,200,Estadio_Azteca,19.302,-99.15,NA,204,171,375,23
2025-06-21 13:00:00,10,Centro,19.4326,-99.1332,L1,116,104,220,13
2025-06-04 06:00:00,10,Centro,19.4326,-99.1332,L1,100,103,203,6
2025-06-08 15:00:00,10,Centro,19.4326,-99.1332,L1,127,115,242,15
2025-06-08 05:00:00,200,Estadio_Azteca,19.302,-99.15,NA,170,197,367,5
2025-06-18 00:00:00,10,Centro,19.4326,-99.1332,L1,94,113,207,0
2025-06-03 21:00:00,200,Estadio_Azteca,19.302,-99.15,NA,170,168,338,21
2025-06-23 03:00:00,120,Tláhuac,19.2978,-99.0123,L12,196,235,431,3
2025-06-11 00:00:00,120,Tláhuac,19.2978,-99.0123,L12,216,211,427,0
2025-06-14 08:00:00,10,Centro,19.4326,-99.1332,L1,371,353,724,8
2025-06-25 21:00:00,10,Centro,19.4326,-99.1332,L1,108,97,205,21
2025-06-23 05:00:00,10,Centro,19.4326,-99.1332,L1,87,89,176,5
2025-06-01 19:00:00,200,Estadio_Azteca,19.302,-99.15,NA,743,679,1422,19
2025-06-09 18:00:00,200,Estadio_Azteca,19.302,-99.15,NA,737,752,1489,18
2025-06-26 06:00:00,120,Tláhuac,19.2978,-99.0123,L12,200,238,438,6
2025-06-24 06:00:00,10,Centro,19.4326,-99.1332,L1,97,85,182,6
2025-06-09 05:00:00,200,Estadio_Azteca,19.302,-99.15,NA,172,185,357,5
2025-06-26 03:00:00,200,Estadio_Azteca,19.302,-99.15,NA,176,179,355,3
2025-06-06 01:00:00,120,Tláhuac,19.2978,-99.0123,L12,240,207,447,1
2025-06-08 00:00:00,200,Estadio_Azteca,19.302,-99.15,NA,190,207,397,0
2025-06-21 00:00:00,200,Estadio_Azteca,19.302,-99.15,NA,178,204,382,0
2025-06-18 21:00:00,120,Tláhuac,19.2978,-99.0123,L12,228,246,474,21
2025-06-26 12:00:00,10,Centro,19.4326,-99.1332,L1,106,93,199,12
2025-06-11 04:00:00,200,Estadio_Azteca,19.302,-99.15,NA,156,169,325,4
2025-06-26 08:00:00,10,Centro,19.4326,-99.1332,L1,371,323,694,8
2025-06-29 20:00:00,120,Tláhuac,19.2978,-99.0123,L12,219,256,475,20
2025-06-16 19:00:00,200,Estadio_Azteca,19.302,-99.15,NA,793,676,1469,19
2025-06-30 01:00:00,120,Tláhuac,19.2978,-99.0123,L12,232,247,479,1
2025-06-29 10:00:00,10,Centro,19.4326,-99.1332,L1,101,102,203,10
2025-06-02 15:00:00,200,Estadio_Azteca,19.302,-99.15,NA,205,170,375,15
2025-06-20 19:00:00,10,Centro,19.4326,-99.1332,L1,383,400,783,19
2025-06-10 19:00:00,200,Estadio_Azteca,19.302,-99.15,NA,695,719,1414,19
2025-06-16 03:00:00,120,Tláhuac,19.2978,-99.0123,L12,242,200,442,3
2025-06-11 08:00:00,200,Estadio_Azteca,19.302,-99.15,NA,593,632,1225,8
2025-06-08 06:00:00,120,Tláhuac,19.2978,-99.0123,L12,217,179,396,6
2025-06-19 20:00:00,200,Estadio_Azteca,19.302,-99.15,NA,172,206,378,20
2025-06-15 15:00:00,10,Centro,19.4326,-99.1332,L1,95,89,184,15
2025-06-08 03:00:00,120,Tláhuac,19.2978,-99.0123,L12,247,215,462,3
2025-06-02 03:00:00,120,Tláhuac,19.2978,-99.0123,L12,226,201,427,3
2025-06-26 01:00:00,120,Tláhuac,19.2978,-99.0123,L12,201,220,421,1
2025-06-14 05:00:00,200,Estadio_Azteca,19.302,-99.15,NA,164,181,345,5
2025-06-30 14:00:00,120,Tláhuac,19.2978,-99.0123,L12,200,223,423,14
2025-06-06 06:00:00,10,Centro,19.4326,-99.1332,L1,93,87,180,6
2025-06-23 01:00:00,200,Estadio_Azteca,19.302,-99.15,NA,209,176,385,1
2025-06-27 21:00:00,10,Centro,19.4326,-99.1332,L1,110,110,220,21
2025-06-02 04:00:00,120,Tláhuac,19.2978,-99.0123,L12,244,209,453,4
2025-06-29 14:00:00,120,Tláhuac,19.2978,-99.0123,L12,215,216,431,14
2025-06-10 08:00:00,120,Tláhuac,19.2978,-99.0123,L12,796,720,1516,8
2025-06-11 18:00:00,120,Tláhuac,19.2978,-99.0123,L12,774,918,1692,18
2025-06-05 13:00:00,10,Centro,19.4326,-99.1332,L1,92,107,199,13
2025-06-01 02:00:00,120,Tláhuac,19.2978,-99.0123,L12,211,216,427,2
2025-06-17 10:00:00,120,Tláhuac,19.2978,-99.0123,L12,240,200,440,10
2025-06-22 10:00:00,200,Estadio_Azteca,19.302,-99.15,NA,169,159,328,10
2025-06-14 14:00:00,200,Estadio_Azteca,19.302,-99.15,NA,192,168,360,14
2025-06-30 06:00:00,200,Estadio_Azteca,19.302,-99.15,NA,180,196,376,6
2025-06-03 06:00:00,10,Centro,19.4326,-99.1332,L1,101,118,219,6
2025-06-21 16:00:00,120,Tláhuac,19.2978,-99.0123,L12,222,198,420,16
2025-06-07 06:00:00,200,Estadio_Azteca,19.302,-99.15,NA,185,190,375,6
2025-06-07 19:00:00,200,Estadio_Azteca,19.302,-99.15,NA,758,651,1409,19
2025-06-15 08:00:00,200,Estadio_Azteca,19.302,-99.15,NA,674,603,1277,8
2025-06-24 15:00:00,200,Estadio_Azteca,19.302,-99.15,NA,175,194,369,15
2025-06-04 23:00:00,10,Centro,19.4326,-99.1332,L1,105,99,204,23
2025-06-29 20:00:00,200,Estadio_Azteca,19.302,-99.15,NA,153,175,328,20
2025-06-02 05:00:00,120,Tláhuac,19.2978,-99.0123,L12,225,217,442,5
2025-06-22 19:00:00,120,Tláhuac,19.2978,-99.0123,L12,897,807,1704,19
2025-06-20 03:00:00,10,Centro,19.4326,-99.1332,L1,100,104,204,3
2025-06-14 22:00:00,10,Centro,19.4326,-99.1332,L1,107,110,217,22
2025-06-13 22:00:00,120,Tláhuac,19.2978,-99.0123,L12,200,220,420,22
2025-06-15 09:00:00,10,Centro,19.4326,-99.1332,L1,111,96,207,9
2025-06-28 02:00:00,200,Estadio_Azteca,19.302,-99.15,NA,191,185,376,2
2025-06-20 22:00:00,200,Estadio_Azteca,19.302,-99.15,NA,182,186,368,22
2025-06-22 08:00:00,120,Tláhuac,19.2978,-99.0123,L12,721,826,1547,8
2025-06-17 07:00:00,10,Centro,19.4326,-99.1332,L1,372,357,729,7
2025-06-29 04:00:00,10,Centro,19.4326,-99.1332,L1,98,97,195,4
2025-06-20 20:00:00,200,Estadio_Azteca,19.302,-99.15,NA,176,176,352,20
2025-06-27 07:00:00,120,Tláhuac,19.2978,-99.0123,L12,816,769,1585,7
2025-06-05 13:00:00,120,Tláhuac,19.2978,-99.0123,L12,223,264,487,13
2025-06-27 16:00:00,200,Estadio_Azteca,19.302,-99.15,NA,165,187,352,16
2025-06-07 03:00:00,200,Estadio_Azteca,19.302,-99.15,NA,201,170,371,3
2025-06-12 14:00:00,120,Tláhuac,19.2978,-99.0123,L12,202,230,432,14
2025-06-30 02:00:00,200,Estadio_Azteca,19.302,-99.15,NA,167,189,356,2
2025-06-19 01:00:00,10,Centro,19.4326,-99.1332,L1,98,105,203,1
2025-06-12 13:00:00,200,Estadio_Azteca,19.302,-99.15,NA,170,204,374,13
2025-06-18 05:00:00,120,Tláhuac,19.2978,-99.0123,L12,221,202,423,5
2025-06-05 20:00:00,120,Tláhuac,19.2978,-99.0123,L12,225,200,425,20
2025-06-16 03:00:00,10,Centro,19.4326,-99.1332,L1,99,101,200,3
2025-06-03 11:00:00,120,Tláhuac,19.2978,-99.0123,L12,195,231,426,11
2025-06-13 20:00:00,200,Estadio_Azteca,19.302,-99.15,NA,190,157,347,20
2025-06-23 04:00:00,120,Tláhuac,19.2978,-99.0123,L12,226,227,453,4
2025-06-30 09:00:00,200,Estadio_Azteca,19.302,-99.15,NA,197,185,382,9
2025-06-02 04:00:00,10,Centro,19.4326,-99.1332,L1,100,103,203,4
2025-06-23 12:00:00,120,Tláhuac,19.2978,-99.0123,L12,197,217,414,12
2025-06-30 07:00:00,200,Estadio_Azteca,19.302,-99.15,NA,653,562,1215,7
2025-06-27 04:00:00,120,Tláhuac,19.2978,-99.0123,L12,207,217,424,4
2025-06-07 08:00:00,200,Estadio_Azteca,19.302,-99.15,NA,673,583,1256,8
2025-06-11 19:00:00,120,Tláhuac,19.2978,-99.0123,L12,1010,842,1852,19
2025-06-16 08:00:00,10,Centro,19.4326,-99.1332,L1,380,344,724,8
2025-06-09 22:00:00,120,Tláhuac,19.2978,-99.0123,L12,193,221,414,22
2025-06-30 13:00:00,200,Estadio_Azteca,19.302,-99.15,NA,184,197,381,13
2025-06-01 18:00:00,120,Tláhuac,19.2978,-99.0123,L12,873,962,1835,18
2025-06-20 09:00:00,120,Tláhuac,19.2978,-99.0123,L12,215,234,449,9
2025-06-24 23:00:00,10,Centro,19.4326,-99.1332,L1,98,89,187,23
2025-06-29 13:00:00,200,Estadio_Azteca,19.302,-99.15,NA,186,170,356,13
2025-06-09 22:00:00,200,Estadio_Azteca,19.302,-99.15,NA,180,208,388,22
2025-06-18 06:00:00,10,Centro,19.4326,-99.1332,L1,96,93,189,6
2025-06-10 09:00:00,10,Centro,19.4326,-99.1332,L1,93,96,189,9
2025-06-04 01:00:00,10,Centro,19.4326,-99.1332,L1,93,102,195,1
2025-06-02 13:00:00,10,Centro,19.4326,-99.1332,L1,100,108,208,13
2025-06-16 23:00:00,10,Centro,19.4326,-99.1332,L1,106,115,221,23
2025-06-20 11:00:00,10,Centro,19.4326,-99.1332,L1,105,90,195,11
2025-06-30 00:00:00,120,Tláhuac,19.2978,-99.0123,L12,220,199,419,0
2025-06-03 10:00:00,120,Tláhuac,19.2978,-99.0123,L12,225,193,418,10
2025-06-15 06:00:00,200,Estadio_Azteca,19.302,-99.15,NA,159,168,327,6
2025-06-09 04:00:00,200,Estadio_Azteca,19.302,-99.15,NA,173,207,380,4
2025-06-14 09:00:00,120,Tláhuac,19.2978,-99.0123,L12,208,216,424,9
2025-06-25 21:00:00,200,Estadio_Azteca,19.302,-99.15,NA,154,181,335,21
2025-06-01 06:00:00,120,Tláhuac,19.2978,-99.0123,L12,197,229,426,6
2025-06-06 21:00:00,120,Tláhuac,19.2978,-99.0123,L12,199,238,437,21
2025-06-22 08:00:00,10,Centro,19.4326,-99.1332,L1,377,341,718,8
2025-06-04 23:00:00,120,Tláhuac,19.2978,-99.0123,L12,208,255,463,23
2025-06-26 05:00:00,10,Centro,19.4326,-99.1332,L1,120,107,227,5
2025-06-06 22:00:00,10,Centro,19.4326,-99.1332,L1,110,97,207,22
2025-06-25 02:00:00,10,Centro,19.4326,-99.1332,L1,102,96,198,2
2025-06-14 16:00:00,200,Estadio_Azteca,19.302,-99.15,NA,173,200,373,16
2025-06-10 07:00:00,120,Tláhuac,19.2978,-99.0123,L12,703,823,1526,7
2025-06-01 10:00:00,200,Estadio_Azteca,19.302,-99.15,NA,181,164,345,10
2025-06-16 16:00:00,120,Tláhuac,19.2978,-99.0123,L12,215,232,447,16
2025-06-11 00:00:00,10,Centro,19.4326,-99.1332,L1,99,94,193,0
2025-06-28 15:00:00,10,Centro,19.4326,-99.1332,L1,88,109,197,15
2025-06-22 06:00:00,200,Estadio_Azteca,19.302,-99.15,NA,187,163,350,6
2025-06-26 13:00:00,200,Estadio_Azteca,19.302,-99.15,NA,170,189,359,13
2025-06-03 23:00:00,200,Estadio_Azteca,19.302,-99.15,NA,182,153,335,23
2025-06-17 02:00:00,200,Estadio_Azteca,19.302,-99.15,NA,157,161,318,2
2025-06-20 18:00:00,200,Estadio_Azteca,19.302,-99.15,NA,770,713,1483,18
2025-06-27 16:00:00,120,Tláhuac,19.2978,-99.0123,L12,225,222,447,16
2025-06-05 12:00:00,10,Centro,19.4326,-99.1332,L1,92,103,195,12
2025-06-08 18:00:00,10,Centro,19.4326,-99.1332,L1,410,352,762,18
2025-06-23 20:00:00,200,Estadio_Azteca,19.302,-99.15,NA,157,190,347,20
2025-06-10 17:00:00,200,Estadio_Azteca,19.302,-99.15,NA,648,759,1407,17
2025-06-15 13:00:00,120,Tláhuac,19.2978,-99.0123,L12,229,218,447,13
2025-06-19 20:00:00,10,Centro,19.4326,-99.1332,L1,102,106,208,20
2025-06-05 17:00:00,10,Centro,19.4326,-99.1332,L1,418,410,828,17
2025-06-09 17:00:00,10,Centro,19.4326,-99.1332,L1,394,392,786,17
2025-06-03 01:00:00,120,Tláhuac,19.2978,-99.0123,L12,225,247,472,1
2025-06-19 23:00:00,200,Estadio_Azteca,19.302,-99.15,NA,155,188,343,23
2025-06-06 00:00:00,120,Tláhuac,19.2978,-99.0123,L12,212,197,409,0
2025-06-02 03:00:00,10,Centro,19.4326,-99.1332,L1,102,98,200,3
2025-06-23 10:00:00,120,Tláhuac,19.2978,-99.0123,L12,230,206,436,10
2025-06-28 15:00:00,200,Estadio_Azteca,19.302,-99.15,NA,181,190,371,15
2025-06-01 16:00:00,120,Tláhuac,19.2978,-99.0123,L12,195,211,406,16
2025-06-07 12:00:00,120,Tláhuac,19.2978,-99.0123,L12,203,232,435,12
2025-06-13 05:00:00,10,Centro,19.4326,-99.1332,L1,86,105,191,5
2025-06-03 03:00:00,10,Centro,19.4326,-99.1332,L1,89,94,183,3
2025-06-15 03:00:00,120,Tláhuac,19.2978,-99.0123,L12,228,228,456,3
2025-06-21 17:00:00,10,Centro,19.4326,-99.1332,L1,360,391,751,17
2025-06-20 00:00:00,10,Centro,19.4326,-99.1332,L1,94,105,199,0
2025-06-23 08:00:00,200,Estadio_Azteca,19.302,-99.15,NA,601,642,1243,8
2025-06-25 02:00:00,200,Estadio_Azteca,19.302,-99.15,NA,213,177,390,2
2025-06-26 22:00:00,200,Estadio_Azteca,19.302,-99.15,NA,165,197,362,22
2025-06-12 21:00:00,120,Tláhuac,19.2978,-99.0123,L12,219,197,416,21
2025-06-07 22:00:00,10,Centro,19.4326,-99.1332,L1,101,101,202,22
2025-06-29 02:00:00,200,Estadio_Azteca,19.302,-99.15,NA,196,179,375,2
2025-06-03 11:00:00,10,Centro,19.4326,-99.1332,L1,100,94,194,11
2025-06-14 10:00:00,120,Tláhuac,19.2978,-99.0123,L12,194,233,427,10
2025-06-21 12:00:00,200,Estadio_Azteca,19.302,-99.15,NA,164,190,354,12
2025-06-28 23:00:00,120,Tláhuac,19.2978,-99.0123,L12,218,212,430,23
2025-06-03 12:00:00,200,Estadio_Azteca,19.302,-99.15,NA,187,206,393,12
2025-06-03 11:00:00,200,Estadio_Azteca,19.302,-99.15,NA,157,177,334,11
2025-06-29 15:00:00,10,Centro,19.4326,-99.1332,L1,96,96,192,15
2025-06-30 10:00:00,10,Centro,19.4326,-99.1332,L1,99,113,212,10
2025-06-26 17:00:00,200,Estadio_Azteca,19.302,-99.15,NA,686,738,1424,17
